ABANDONED	ABANDON, to leave or give up completely [v]
ABBREVIATION	the act or result of abbreviating [n -S]
ABOLITION	the act of doing away with [n -S]
ABSEIL	(German) to descend a rock face using a double rope, to rappel [v -ED, -ING, -S]
ABSOLUTELY	ABSOLUTE, unconditional, fundamental [adv]
ACCELERATE	to bring about at an earlier time [v ACCELERATED, ACCELERATING, ACCELERATES]
ACCESSIBLE	able to be accessed [adj ACCESSIBLY]
ACCIDENTAL	by accident [adj ACCIDENTALLY] / a nonessential property [n -S]
ACCIDENTALLY	ACCIDENTAL, by accident [adv]
ACCOMMODATION	traveling space and related services [n -S]
ACCORD	to bring into agreement [v -ED, -ING, -S]
ACCUMULATE	to gather or pile up esp. little by little [v ACCUMULATED, ACCUMULATING, ACCUMULATES]
ACCURATELY	ACCURATE, free from error [adv]
ACCUSATION	the act of accusing [n -S]
ACKNOWLEDGE	to recognize the rights, authority, or status of [v ACKNOWLEDGED, ACKNOWLEDGING, ACKNOWLEDGES]
ACQUAINTED	ACQUAINT, to cause to know [v]
ACTION	activity, a deed [n] / to carry out [v -ED, -ING, -S]
ADAMANT	very firm [adj ADAMANTLY] / a legendary impenetrable stone; diamond [n -S]
ADDICTION	the state of being addicted [n -S]
ADJUSTED	ADJUST, to bring to a more satisfactory state [v]
ADJUSTMENT	the act of adjusting [n -S]
ADMISSION	the act of admitting [n -S]
ADMONISH	to reprove mildly [v -ED, -ING, -ES]
ADORABLE	worthy of being adored [adj]
ADVANTAGE	to confer an advantage, a favourable condition, upon [v ADVANTAGED, ADVANTAGING, ADVANTAGES]
ADVENTURES	ADVENTURE, to risk, to dare, also AVENTURE [v]
ADVENTUROUS	disposed to seek adventure [adj ADVENTUROUSLY]
ADVISABLE	sensible, to be recommended [adj]
AFFECTION	a fond feeling [n] / to love [v -ED, -ING, -S]
AFRAID	struck with fear [adj]
AGAINST	opposite to [prep]
AGORAPHOBIA	a morbid fear of open spaces [n -S]
AISLE	a passage between seats [n -S]
ALCOHOL	(Arabic) a flammable liquid [n -S]
ALIEN	foreign [adj ALIENLY] / to alienate [v -ED, -ING, -S]
ALIENATE	to make indifferent or unfriendly [v ALIENATED, ALIENATING, ALIENATES]
ALLERGIC	suffering from an allergy [adj] / one who suffers from an allergy [n -S]
ALPACA	a domestic animal related to the llama [n -S]
ALPHABET	a set of letters [n -S] / to alphabetize [v -ED, -ING, -S]
ALTHOUGH	despite the fact that [conj]
AMBITION	aspiration after success or advancement [n -S] / to seek with eagerness [v -ED, -ING, -S]
AMUSE	to entertain [v AMUSED, AMUSING, AMUSES]
ANALYZE	to subject to analysis, also ANALYSE [v ANALYZED, ANALYZING, ANALYZES]
ANCHOR	a device for holding a floating vessel in place [n -S] / to secure by means of an anchor [v -ED, -ING, -S]
ANGRIEST	ANGRY, having anger [adj]
ANNOY	to be troublesome to [v -ED, -ING, -S]
ANNUAL	happening every year [adj ANNUALLY] / a plant that flowers for one year only [n -S]
ANNUALLY	ANNUAL, happening every year [adv]
ANOINT	to consecrate with oil [v -ED, -ING, -S]
ANSWER	to say, write, or act in return [v -ED, -ING, -S]
ANSWERED	ANSWER, to say, write, or act in return [v]
ANTIBIOTIC	inhibiting to life [adj ANTIBIOTICALLY] / a substance derived from a microorganism and able in dilute solution to inhibit or kill another microorganism [n -S]
ANTIBIOTICS	ANTIBIOTIC, a substance derived from a microorganism and able in dilute solution to inhibit or kill another microorganism [n]
ANTISEPTIC	inhibiting the growth of microorganisms [adj ANTISEPTICALLY] / a substance that inhibits the growth or action of microorganisms [n -S]
APOLOGY	an explanation with expression of regret [n APOLOGIES]
APPALLING	APPALL, to horrify, also APPAL [v]
APPARENT	seeming [adj APPARENTLY] / (Shakespeare) an heir-apparent [n -S]
APPEAR	to become visible [v -ED, -ING, -S]
APPEARANCE	external show [n -S]
APPETITE	a desire for food or drink [n -S]
APPLAUDED	APPLAUD, to express approval by clapping the hands [v]
APPLICABLE	that can be applied, also APPLIABLE [adj]
APPLICANT	one who applies [n -S]
APPLICATOR	a device used to applicate something [n -S]
APPLIED	APPLY, to bring to bear [v]
APPLYING	APPLY, to bring to bear [v]
APPREHEND	to understand [v -ED, -ING, -S]
APPRENTICESHIP	the state of being an apprentice [n -S]
APPRENTICESHIPS	APPRENTICESHIP, the state of being an apprentice [n]
APPROPRIATE	suitable [adj APPROPRIATELY] / to take exclusive possession of [v APPROPRIATED, APPROPRIATING, APPROPRIATES]
AQUARIUM	(Latin) a water filled museum for all forms of aquatic life [n AQUARIUMS or AQUARIA]
ARACHNOPHOBIA	fear of spiders [n -S]
ARCHAEOLOGY	the study of ancient human artefacts, also ARCHEOLOGY [n ARCHAEOLOGIES]
ARCHERY	the sport of shooting with bows and arrows [n ARCHERIES]
ARCHIVES	ARCHIVE, to file in an archive [v]
AREA	(Latin) a region [n AREAS] / part of the cerebral cortex [n AREAE]
ARGUMENT	an exchange of differing reasons [n -S]
ARRANGEMENT	a preliminary measure [n -S]
ARRANGING	ARRANGE, to put in order [v]
ARROGANT	overbearing [adj ARROGANTLY]
ARTIFICIAL	humanly contrived often on a natural model [adj ARTIFICIALLY]
ASSERT	to state positively [v -ED, -ING, -S]
ASSESS	to estimate the value of for taxation [v -ED, -ING, -ES]
ASSESSMENT	the act of assessing [n -S]
ATTACHMENT	something attached [n -S]
ATTENTION	the act of attending [n -S]
ATTIRE	to clothe [v ATTIRED, ATTIRING, ATTIRES]
ATTRIBUTE	to ascribe [v ATTRIBUTED, ATTRIBUTING, ATTRIBUTES]
ATYPICAL	not typical, also ATYPIC [adj ATYPICALLY]
AUCTION	to sell publicly to the highest bidder [v -ED, -ING, -S]
AUDIENCE	a group of listeners or spectators [n -S]
AUDITORIUM	(Latin) the part of a theatre, lecture-hall, or other public building occupied by the audience [n AUDITORIUMS or AUDITORIA]
AUTHOR	to bring into being [v -ED, -ING, -S]
AUTUMN	a season of the year [n -S]
AVIATOR	a pilot who flies aircraft [n -S]
AVOIDABLE	capable of being avoided [adj AVOIDABLY]
AVOIDANCE	the act of avoiding [n -S]
AWESOME	impressive or inspiring awe, also AWSOME [adj]
AWKWARDLY	AWKWARD, lacking grace [adv]
AWRY	askew [adv]
BADGE	to supply with an insignia [v BADGED, BADGING, BADGES]
BALLAST	heavy material used to weigh down and steady a ship or balloon [n -S] / to load with ballast [v -ED, -ING, -S]
BAMBOOZLE	to deceive by underhanded methods; to frustrate [v BAMBOOZLED, BAMBOOZLING, BAMBOOZLES]
BANKSIA	an evergreen, flowering shrub, native to Australia [n -S]
BARBARIAN	a member of a primitive or uncivilized people; a coarse, insensitive, or uncultured person [n -S]
BARELY	BARE, unclothed, uncovered [adv]
BARGAIN	to haggle over costs [v -ED, -ING, -S]
BARRAGE	to subject to a massive attack [v BARRAGED, BARRAGING, BARRAGES]
BARREL	to move fast [v BARRELED or BARRELLED, BARRELING or BARRELLING, BARRELS]
BARRISTER	a person who is qualified to plead at the bar in a lawcourt [n -S]
BAUBLE	a cheap trinket, also BAWBLE [n -S]
BEACON	to shine like a light on high [v -ED, -ING, -S]
BEAUTICIAN	a person engaged in hairdressing, facial makeup, manicuring, etc. [n -S]
BEDROOM	a room for sleeping [n -S]
BEETROOT	the dark-red root of the beet plant eaten as a vegetable [n -S]
BEGINNER	one who begins, a novice [n -S]
BEHAVIOR	conduct, also BEHAVIOUR [n -S]
BEHAVIORS	BEHAVIOR, conduct, also BEHAVIOUR [n]
BEIGE	a woollen fabric of undyed wool [n -S] / greyish buff with a hint of pink [adj BEIGER, BEIGEST]
BELIEVE	to accept as true [v BELIEVED, BELIEVING, BELIEVES]
BELLIGERENCE	an aggressive or truculent attitude, also BELLIGERENCY [n -S]
BENEFITED	BENEFIT, to obtain an advantage [v]
BENEVOLENT	marked by or disposed to doing good [adj BENEVOLENTLY]
BERRIES	BERRY, to collect berries [v]
BESIEGE	to attack and surround [v BESIEGED, BESIEGING, BESIEGES]
BIGGER	BIG, of large size [adj]
BILBY	(Native Australian) a burrowing marsupial of Australia [n BILBIES]
BIZARRE	strange [adj BIZARRELY] / a strangely striped flower [n -S]
BLACKBIRD	a bird of the thrush family [n -S] / to traffic in slaves [v -ED, -ING, -S]
BLUDGEON	to hit with a club [v -ED, -ING, -S]
BONFIRE	a large fire in the open air [n -S]
BOUGH	a tree branch [n -S]
BOUGHT	(Spenser) a coil, fold [n -S]
BOUNCED	BOUNCE, to spring back [v]
BOUQUET	(French) a bunch of flowers [n -S]
BOYCOTT	to refuse to have dealings with [v -ED, -ING, -S]
BRAKE	to slow down or stop [v BRAKED, BRAKING, BRAKES]
BREAD	to cover with breadcrumbs [v -ED, -ING, -S]
BREAK	to shatter or damage [v BROKE, BROKEN, BREAKING, BREAKS]
BREAKABLE	that can be broken [adj] / something that can be broken [n -S]
BREATHE	to inhale and exhale air [v BREATHED, BREATHING, BREATHES]
BRETHREN	BROTHER, a male sibling [n]
BRIDGE	to connect across a gap [v BRIDGED, BRIDGING, BRIDGES]
BRIEF	to give instructions [v -ED, -ING, -S] / short [adj BRIEFER, BRIEFEST, BRIEFLY]
BRILLIANT	shining [adj BRILLIANTLY] / to cut and polish a diamond [v -ED, -ING, -S]
BROCCOLI	a plant of the cabbage species, resembling the cauliflower, also BROCOLI [n -S]
BROUGHT	BRING, to take with oneself to a place [v]
BRUSQUE	abrupt in manner, also BRUSK [adj BRUSQUER, BRUSQUEST, BRUSQUELY]
BULLION	uncoined gold or silver [n -S]
BURIED	BURY, to put in the ground and cover with earth [v]
BURNISH	to polish [v -ED, -ING, -ES]
CALCULATED	CALCULATE, to count or reckon [v]
CALCULATORS	CALCULATOR, one that calculates [n]
CALF	a young cow [n CALVES] / the skin of a calf, calfskin [n -S]
CALM	to become not agitated [v -ED, -ING, -S] / free from agitation [adj CALMER, CALMEST, CALMLY]
CALVES	CALVE, to give birth to a calf [v]
CAMOUFLAGE	to conceal or disguise by camouflage [v CAMOUFLAGED, CAMOUFLAGING, CAMOUFLAGES]
CAMPAIGN	to conduct an operation to achieve a certain goal [v -ED, -ING, -S]
CANCELING	CANCEL, to cause not to happen [v]
CANCELLATION	the act or an instance of cancelling, also CANCELATION [n -S]
CANOE	to paddle a small slender boat [v CANOED, CANOEING, CANOES]
CAPABLE	competent [adj CAPABLER, CAPABLEST, CAPABLY]
CAREFULLY	CAREFUL, cautious [adv]
CASHMERE	a soft twilled fabric made of fine goat's wool, also CASIMERE, CASIMIRE, CASSIMERE, KASHMIR, KERSEYMERE [n -S]
CATALOGUE	to make a systematic list of names, books, pictures, etc., also CATALOG, CATELOG [v CATALOGUED, CATALOGUING, CATALOGUES]
CAUTION	to warn [v -ED, -ING, -S]
CEILING	the overhead lining of a room [n -S]
CELEBRATE	to mark by solemn ceremonies [v CELEBRATED, CELEBRATING, CELEBRATES]
CELEBRATED	CELEBRATE, to mark by solemn ceremonies [v]
CELEBRATING	CELEBRATE, to mark by solemn ceremonies [v]
CELEBRITIES	CELEBRITY, a well-known person [n]
CELEBRITY	a well-known person [n CELEBRITIES]
CELLOPHANE	(tradename) a tough transparent wrapping material [n -S]
CEMENT	to bind firmly [v -ED, -ING, -S]
CERTIFICATE	to testify to or authorize by a certificate [v CERTIFICATED, CERTIFICATING, CERTIFICATES]
CHALET	a type of wooden house of Swiss origin, typically low, with wide projecting eaves [n -S]
CHAOS	(Greek) a state of total disorder [n -ES]
CHARACTERS	CHARACTER, (archaic) to engrave, inscribe [v]
CHEMICAL	related to chemistry [adj CHEMICALLY] / a substance obtained by a process of chemistry [n -S]
CHEMIST	one versed in chemistry [n -S]
CHILDHOOD	the state of being a child [n -S]
CHILLIER	CHILLY, cool [adj]
CHIVALRY	knightly behaviour, bravery and courtesy [n CHIVALRIES]
CHLOROFORM	to treat with or as if with the colourless volatile liquid chloroform esp. so as to produce anesthesia [v -ED, -ING, -S]
CHOPPER	to travel by helicopter [v -ED, -ING, -S]
CHORD	to play a combination of three or more musical notes [v -ED, -ING, -S]
CHORUS	to sing in unison [v CHORUSSED or CHORUSED, CHORUSSING or CHORUSING, CHORUSSES or CHORUSES]
CHROMOSOMES	CHROMOSOME, a threadlike body containing the genetic material in the cell nucleus [n]
CHRONIC	long-lasting [adj CHRONICALLY] / a chronic invalid [n -S]
CIGARETTE	finely-cut tobacco rolled in thin paper, also CIGARET [n -S]
CINNAMON	the spicy bark of a lauraceous tree of Sri Lanka [n -S]
CIRCLE	to revolve around [v CIRCLED, CIRCLING, CIRCLES]
CIRCUIT	to move around [v -ED, -ING, -S]
CIRCULAR	in the shape of a circle [adj CIRCULARLY] / a leaflet intended for wide distribution [n -S]
CIRCULATION	the movement of the blood round the body [n -S]
CIRCUMFERENCE	the perimeter of a circle [n -S]
CIRCUMSTANCE	a condition, fact, or event accompanying, conditioning, or determining another [n -S] / to place in particular circumstances [v CIRCUMSTANCED, CIRCUMSTANCING, CIRCUMSTANCES]
CIRCUMSTANCES	CIRCUMSTANCE, to place in particular circumstances [v]
CIRCUMSTANTIAL	belonging to, consisting in, or dependent on circumstances [n -S]
CITIZEN	a resident of a city [n -S]
CITY	a large town [n CITIES]
CIVILIAN	a nonmilitary person [n -S]
CLOAKROOM	a room in which coats etc. are stored [n -S]
CLOSING	a concluding part [n -S]
CLUMSIER	CLUMSY, not dexterous [adj]
CLUMSIEST	CLUMSY, not dexterous [adj]
COAST	to cycle without pedalling [v -ED, -ING, -S]
COAX	to cajole [v COAXED, COAXING, COAXES]
COHESION	the act of sticking together [n -S]
COLLECTOR	one who collects [n -S]
COLLEGE	a school of higher learning [n -S]
COLLISION	the state of being struck together [n -S]
COLOGNE	(French) a perfumed mixture of alcohol and essential oils, first made at Cologne [n -S]
COLORED	a colored person [n -S]
COMFORTABLE	affording comfort [adj COMFORTABLY]
COMFORTABLY	COMFORTABLE, affording comfort [adv]
COMMISSIONER	a person who holds a commission [n -S]
COMMITMENT	the state of being committed [n -S]
COMPLAIN	to express discontent [v -ED, -ING, -S]
COMPLAINING	express discontent [adj COMPLAININGLY] / the act of complaining [n -S]
COMPLEMENTARY	serving to complement [adj COMPLEMENTARILY] / a complement [n COMPLEMENTARIES]
COMPLIMENTARY	by way of compliment [adj COMPLIMENTARILY]
CONCEITED	having a good opinion of oneself [adj CONCEITEDLY]
CONCERN	to be of interest to [v -ED, -ING, -S]
CONCERT	to construct or devise together [v -ED, -ING, -S]
CONCLUSION	a result, outcome [n -S]
CONDENSATION	the act of condensing [n -S]
CONFER	to bestow [v CONFERRED, CONFERRING, CONFERS]
CONFETTI	CONFETTO, (Italian) a small piece of paper thrown at a wedding [n]
CONFIDENCE	a feeling or consciousness of one's powers or of reliance on one's circumstances, also CONFIDENCY [n -S]
CONFIDENTIAL	marked by intimacy or willingness to confide [adj CONFIDENTIALLY]
CONSCIENCE	the sense of moral correctness that governs or influences a person's actions or thoughts [n -S]
CONSCIOUS	having the feeling or knowledge of something [adj CONSCIOUSLY] / the conscious mind [n -ES]
CONSEQUENCE	a conclusion derived through logic [n -S] / (archaic) to draw a consequence from [v CONSEQUENCED, CONSEQUENCING, CONSEQUENCES]
CONSIDERATE	marked by or given to careful consideration [adj CONSIDERATELY]
CONSTERNATION	amazement or dismay that hinders or throws into confusion [n -S]
CONTEMPT	scorn [n -S]
CONTINUOUS	marked by uninterrupted extension in space, time, or sequence [adj CONTINUOUSLY]
CONTROLLING	CONTROL, to exercise authority over, also CONTROUL [v]
CONVERSATION	communication by talking [n -S]
CONVINCE	to satisfy as to truth or error [v CONVINCED, CONVINCING, CONVINCES]
COORDINATOR	one who coordinates [n -S]
CORDUROY	to build a road reinforced with transverse logs [v -ED, -ING, -S]
CORPSES	CORPSE, to forget one's lines [v]
CORRESPOND	to be in conformity or agreement [v -ED, -ING, -S]
CORROSION	the act of eating, wearing, or wasting away [n -S]
COSIEST	COSY, snug and comfortable, also COZY [adj]
COUNTERFEIT	imitation, also COUNTERFECT [adj COUNTERFEITLY] / to imitate or feign esp. with intent to deceive [v -ED, -ING, -S]
COUNTRIES	COUNTRY, the territory of a nation [n]
COURAGEOUS	having or characterized by courage [adj COURAGEOUSLY]
CRAFTSMANSHIP	the skills of craftsman, also CRAFTMANSHIP [n -S]
CRAZIEST	CRAZY, insane [adj]
CREDIBLE	believable [adj]
CREVICE	a cleft [n -S]
CREW	to serve aboard a ship [v -ED, -ING, -S]
CRYING	distressing, heartbreaking, lamentable, as in a crying shame [adj CRYINGLY] / the act of crying [n -S]
CRYSTAL	a transparent mineral [n -S]
CULPABLE	blameworthy [adj CULPABLY]
CUMBERSOME	burdensome [adj CUMBERSOMELY]
CUPBOARD	an item of furniture or a recess fitted with a door, used for storage [n -S] / to store [v -ED, -ING, -S]
CURIOUS	inquisitive [adj CURIOUSER, CURIOUSEST, CURIOUSLY]
CUTTER	a powerful motor-launch (as used by coastguard and navy) [n -S]
DAIS	(French) a raised platform [n -ES]
DAMAGE	to damage [v DAMAGED, DAMAGING, DAMAGES]
DANCED	DANCE, to move rhythmically to music [v]
DANCING	the act of dancing [n -S]
DANGER	to expose to loss or injury [v -ED, -ING, -S]
DATABASE	a collection of data in a computer, also DATABANK [n -S] / to put data into a database [v DATABASED, DATABASING, DATABASES]
DAUGHTER	a female child [n -S]
DEATH	the end of life [n -S]
DEBT	something that is owed [n -S]
DECEIVE	to mislead by falsehood [v DECEIVED, DECEIVING, DECEIVES]
DECIDED	DECIDE, to make a choice [v]
DECOMPOSING	DECOMPOSE, to fall to pieces [v]
DECORUM	(Latin) proper behaviour [n -S]
DECREASE	to diminish, also DECREW [v DECREASED, DECREASING, DECREASES]
DECREASED	DECREASE, to diminish, also DECREW [v]
DELICATESSEN	ready to eat food products, such as cooked meats and prepared salads [n -S]
DELIGHTFUL	full of delight [adj DELIGHTFULLY]
DELIRIOUS	mentally confused, esp. through fever or other illness [adj DELIRIOUSLY]
DENIES	DENY, to declare to be untrue, also DENAY [v]
DENYING	DENY, to declare to be untrue, also DENAY [v]
DEPENDENCY	the state of being dependent, also DEPENDANCE, DEPENDANCY, DEPENDENCE [n DEPENDENCIES]
DEPOT	a railway or bus station [n -S]
DEPRESSION	a pressing down [n -S]
DERELICT	anything forsaken or abandoned [n -S]
DESCRIPTION	an act of describing [n -S]
DESERTS	DESERT, to abandon [v]
DESERVING	worthy [adj DESERVINGLY] / the act of deserving [n -S]
DESIGNED	DESIGN, to plan in outline, also DESINE, DESYNE [v]
DESPAIR	to lose all hope [v -ED, -ING, -S]
DESPERATE	in a state of despair [adj DESPERATELY]
DESSERT	a final course of a meal [n -S]
DESTROY	to damage beyond repair or renewal, also STROY [v -ED, -ING, -S]
DETECTIVE	a policeman, usually not in uniform, or other person (private detective) who investigates cases of crime [n -S]
DETRIMENT	diminution; damage [n -S]
DEVELOPMENT	the act of developing [n -S]
DICTATORSHIP	the office of dictator [n -S]
DICTIONARIES	DICTIONARY, a book containing the words of a language alphabetically arranged, with their meanings, etymology, etc. [n]
DIFFERENCE	to make or perceive a difference between or in, also DIFFERENCY [v DIFFERENCED, DIFFERENCING, DIFFERENCES]
DIGEST	to assimilate food in the stomach, also DISGEST [v -ED, -ING, -S]
DIGGING	an excavation [n -S]
DIRECTING	DIRECT, to control or conduct the affairs of [v]
DIRECTION	aim at a certain point [n -S]
DIRECTOR	one that directs [n -S]
DIRECTORY	a body of directions, a guide [n DIRECTORIES]
DIRTIER	DIRTY, soiled [adj]
DIRTIEST	DIRTY, soiled [adj]
DISALLOW	to refuse to allow [v -ED, -ING, -S]
DISAPPEAR	to vanish from sight [v -ED, -ING, -S]
DISAPPOINT	to fail to meet the expectation or hope of [v -ED, -ING, -S]
DISAPPOINTED	DISAPPOINT, to fail to meet the expectation or hope of [v]
DISAPPROVE	to pass unfavorable judgment on [v DISAPPROVED, DISAPPROVING, DISAPPROVES]
DISASSEMBLE	to take apart [v DISASSEMBLED, DISASSEMBLING, DISASSEMBLES]
DISBELIEF	lack of belief [n -S]
DISCHARGE	to free from or relieve of a charge of any kind [v DISCHARGED, DISCHARGING, DISCHARGES]
DISCOLOUR	to alter the natural hue or color of, also DISCOLOR [v -ED, -ING, -S]
DISCOMFORT	to make uncomfortable or uneasy [v -ED, -ING, -S]
DISCONNECT	to sever the connection of or between [v -ED, -ING, -S]
DISCONTENT	to make discontented [v -ED, -ING, -S]
DISCONTINUE	to break the continuity of [v DISCONTINUED, DISCONTINUING, DISCONTINUES]
DISCOURAGE	to dishearten; to depress the spirits of [v DISCOURAGED, DISCOURAGING, DISCOURAGES]
DISCOVER	to find out, also DISCOURE, DISCURE [v -ED, -ING, -S]
DISCRETION	the quality of being discreet [n -S]
DISCUSSION	consideration of a question in open and usually informal debate [n -S]
DISEASE	to make unhealthy [v DISEASED, DISEASING, DISEASES]
DISEMBARKING	DISEMBARK, to leave a ship, to land [v]
DISFIGURE	to spoil the appearance of [v DISFIGURED, DISFIGURING, DISFIGURES]
DISINTEGRATE	to break or decompose into constituent elements, parts, or small particles [v DISINTEGRATED, DISINTEGRATING, DISINTEGRATES]
DISOBEDIENT	refusing or neglecting to obey [adj DISOBEDIENTLY]
DISQUALIFIED	DISQUALIFY, to debar [v]
DISTINGUISHED	DISTINGUISH, to perceive a difference in [v]
DITCH	to dig a long, narrow excavation in the ground [v -ED, -ING, -ES]
DOCTOR	to treat medically [v -ED, -ING, -S]
DOCUMENT	to support by conclusive information [v -ED, -ING, -S]
DOMINANT	controlling [adj DOMINANTLY] / a controlling genetic character [n -S]
DOUBT	to be uncertain about [v -ED, -ING, -S]
DOUBTFUL	worthy of doubt [adj DOUBTFULLY] / something doubtful e.g. a starter in a race [n -S]
DRAGGED	DRAG, to pull along the ground [v]
DRAGGING	a technique in interior decoration, in which a brush is pulled through freshly-applied paint to give an irregular decorative effect [n -S]
DRAWER	one that draws [n -S]
DRIPPED	DRIP, to fall in drops [v]
DROPPED	DROP, to let fall in globules [v]
DRUMMER	one who plays a drum [n -S]
DRYING	the act of drying [n -S]
DUMB	incapable of speech [adj DUMBER, DUMBEST, DUMBLY] / to deprive of speech [v -ED, -ING, -S]
DUNGEON	to confine in an underground prison [v -ED, -ING, -S]
DURESS	compulsion by force, also DURESSE [n -ES]
DUSTIEST	DUSTY, full of dust [adj]
EARLY	an early potato [n EARLIES] / before the due time [adj EARLIER, EARLIEST]
EARTH	to cover with soil [v -ED, -ING, -S]
EARTHQUAKES	EARTHQUAKE, a quaking or shaking of the earth [n]
ECCENTRIC	odd or unconventional, also ECCENTRICAL [adj ECCENTRICALLY] / one who is odd or unconventional [n -S]
EDGE	to furnish with a border [v EDGED, EDGING, EDGES]
EDIBLE	something fit to be eaten [n -S]
EDUCATION	bringing up or training esp. of a child [n -S]
EDUCATIONAL	serving to educate [adj EDUCATIONALLY]
EERIE	uncanny, also EERY [adj EERIER, EERIEST, EERILY]
EFFECT	to bring about [v -ED, -ING, -S]
EFFERVESCENT	frothing, bubbling [adj EFFERVESCENTLY]
EFFICIENT	capable of doing what may be required [adj EFFICIENTLY] / a trained soldier, esp. one volunteering for service [n -S]
ELECTRIC	relating to electricity [adj ELECTRICALLY] / an electric vehicle, machine etc. [n -S]
ELECTRICAL	relating to electricity [adj ELECTRICALLY]
ELECTRICITY	the manifestation of a form of energy associated with separation or movement of charged particles, such as electrons and protons [n ELECTRICITIES]
ELEPHANT	a large tusked mammal [n -S]
ELOCUTION	the art of effective speaking [n -S]
EMBARRASS	to discomfit [v -ED, -ING, -ES]
EMBEZZLEMENT	the act of embezzling [n -S]
EMBROIDERY	the art or process of forming decorative designs with hand or machine needlework, also BROIDERY [n EMBROIDERIES]
EMERGED	EMERGE, to come into view [v]
EMERGENCY	an unexpected occurrence, requiring immediate action [n EMERGENCIES]
EMPEROR	the ruler of an empire [n -S]
EMPLOY	to hire, use [v -ED, -ING, -S]
EMPLOYMENT	the act of employing [n -S]
ENAMEL	to cover with a vitrified coating [v ENAMELED or ENAMELLED, ENAMELING or ENAMELLING, ENAMELS]
ENDEAVOR	to strive or attempt [v -ED, -ING, -S]
ENDEAVOURED	ENDEAVOUR, to try, also ENDEAVOR [v]
ENERGETIC	full of energetic, also ENERGETICAL [adj ENERGETICALLY]
ENERGY	the power required for doing work [n ENERGIES]
ENGAGE	to employ [v ENGAGED, ENGAGING, ENGAGES]
ENGAGEMENT	an arrangement to meet or be present at a specified time and place [n -S]
ENGINE	to equip with machinery [v ENGINED, ENGINING, ENGINES]
ENHANCEMENT	the act of enhancing [n -S]
ENJOYABLE	that can be enjoyed [adj ENJOYABLY]
ENORMOUS	huge, also ENORM [adj ENORMOUSLY]
ENQUIRE	to ask, also INQUERE, INQUIRE [v ENQUIRED, ENQUIRING, ENQUIRES]
ENSURE	to make sure [v ENSURED, ENSURING, ENSURES]
ENTERTAIN	to hold the attention or thoughts of; to amuse [v -ED, -ING, -S]
ENTIRELY	completely [adv]
ENTRANCE	to fill with delight [v ENTRANCED, ENTRANCING, ENTRANCES]
ENVIABLE	causing envy [adj]
ENVIRONMENT	the circumstances, objects, or conditions by which one is surrounded [n -S]
EQUALLY	in an equal way, also EGALLY [adv]
EQUESTRIAN	one who rides on horseback [n -S]
EQUIVALENT	equal in force, amount, or value [adj EQUIVALENTLY] / something equal [n -S]
EQUIVOCATE	to use equivocal or doubtful words in order to mislead or to avoid answering a question [v EQUIVOCATED, EQUIVOCATING, EQUIVOCATES]
EROSION	the act of eroding [n -S]
ESCAPED	ESCAPE, to free oneself [v]
ESPECIALLY	ESPECIAL, special [adv]
ESTABLISH	to settle or fix, also STABLISH [v -ED, -ING, -ES]
ESTEEM	to have a high opinion of, also STEEM [v -ED, -ING, -S]
EUPHEMISM	a figure of rhetoric by which an unpleasant or offensive thing is described or referred to by a milder term [n -S]
EUPHORIC	overjoyed [adj EUPHORICALLY]
EVIDENCE	to make apparent or visible [v EVIDENCED, EVIDENCING, EVIDENCES]
EVIDENT	clear [adj EVIDENTLY] / that which serves as evidence [n -S]
EXCEEDED	EXCEED, to go beyond the limit [v]
EXCEPT	to exclude, leave out [v -ED, -ING, -S]
EXCEPTIONAL	by way of an exception [adj EXCEPTIONALLY] / someone having above or below average intelligence [n -S]
EXCEPTIONALLY	EXCEPTIONAL, by way of an exception [adv]
EXCITE	to arouse the emotions of [v EXCITED, EXCITING, EXCITES]
EXCLAIM	to cry out in surprise [v -ED, -ING, -S]
EXCLAIMED	EXCLAIM, to cry out in surprise [v]
EXCURSION	a pleasure trip [n -S] / to go on an excursion [v -ED, -ING, -S]
EXCURSIONS	EXCURSION, to go on an excursion [v]
EXERCISING	EXERCISE, to perform a set drill [v]
EXHALE	to breathe out [v EXHALED, EXHALING, EXHALES]
EXHIBIT	to display publicly [v -ED, -ING, -S]
EXHIBITED	EXHIBIT, to display publicly [v]
EXHIBITION	an act or instance of exhibiting [n -S]
EXHUMED	EXHUME, to dig out from the earth, also EXHUMATE [v]
EXILE	to banish from one's own country [v EXILED, EXILING, EXILES]
EXIT	to go out [v -ED, -ING, -S]
EXPLAIN	to make clear and understandable [v -ED, -ING, -S]
EXPLANATION	the act of explaining [n -S]
EXPLANATORY	serving to explain, also EXPLANATIVE [adj EXPLANATORILY]
EXPLODE	to blow up [v EXPLODED, EXPLODING, EXPLODES]
EXPLOIT	to take advantage of [v -ED, -ING, -S]
EXPLOITED	EXPLOIT, to take advantage of [v]
EXPLORING	EXPLORE, to examine thoroughly [v]
EXPLOSION	the act of exploding [n -S]
EXPORT	to send goods out of a country [v -ED, -ING, -S]
EXTEND	to stretch out to full length [v -ED, -ING, -S]
EXTENSION	an act of extending [n -S]
FACILITATE	to make easier [v FACILITATED, FACILITATING, FACILITATES]
FACTORIES	FACTORY, a place where goods are manufactured [n]
FANCY	to take a liking to [v FANCIED, FANCYING, FANCIES] / ornamental [adj FANCIER, FANCIEST, FANCILY]
FASTIDIOUS	showing a meticulous or demanding attitude [adj FASTIDIOUSLY]
FATALLY	FATAL, capable of causing death [adv]
FATHERHOOD	the state of being a father [n -S]
FATTER	FAT, having an abundance of flesh [adj]
FAVORITE	(US) favourite, a person or thing preferred [n -S]
FEASIBLE	capable of being done [adj FEASIBLY]
FEATURE	to present prominently [v FEATURED, FEATURING, FEATURES]
FELONY	a grave crime [n FELONIES]
FETCH	to go after and bring back [v -ED, -ING, -ES]
FETE	(French) to honour with festivities [v FETED, FETING, FETES]
FIERCE	violently hostile or aggressive [adj FIERCER, FIERCEST, FIERCELY]
FIERY	intensely hot [adj FIERIER, FIERIEST, FIERILY]
FIGURE	to compute [v FIGURED, FIGURING, FIGURES]
FIGURINE	a small modelled or sculpted figure [n -S]
FITTED	FIT, to adjust to the right size [v]
FITTER	one that fits [n -S]
FLAG	to mark with a cloth used as a symbol [v FLAGGED, FLAGGING, FLAGS]
FLAPPING	the act of flapping [n -S]
FLUORIDE	a compound of fluorine, also FLUORID [n -S]
FOOTBALL	a large ball for kicking about in sport [n -S]
FOREGROUND	to bring to the foreground, the part of a picture or field of view nearest the observer's eye [v -ED, -ING, -S]
FOREIGNER	a person belonging to, or from, another country [n -S]
FORGETFULLY	FORGETFUL, inclined to forget [adv]
FORMAL	regulated, not casual [adj FORMALLY] / a social event that requires evening dress [n -S]
FORTUITOUS	occurring by chance [adj FORTUITOUSLY]
FOUGHT	FIGHT, to contend in war, battle or single combat [v]
FOUNTAIN	to display water like small waterfalls [v -ED, -ING, -S]
FRACTURES	FRACTURE, to break [v]
FRENZIED	FRENZY, to make frantic, also PHRENSY [v]
FREQUENCY	commonness of recurrence, also FREQUENCE [n FREQUENCIES]
FRIEND	to enter into a warm association with [v -ED, -ING, -S]
FRIENDLY	one who is friendly [n FRIENDLIES] / amicable [adj FRIENDLIER, FRIENDLIEST, FRIENDLILY]
FRIGATE	a class of war vessels intermediate between corvettes and ships of the line [n -S]
FRIGHTENED	FRIGHTEN, to make afraid, to scare, also FRIGHT [v]
FRYING	the process of frying [n -S]
FUDGE	to falsify [v FUDGED, FUDGING, FUDGES]
FULFIL	to bring about the accomplishment of, also FULFILL [v FULFILLED, FULFILLING, FULFILS]
FUMIGATE	to subject to fumes to kill pests [v FUMIGATED, FUMIGATING, FUMIGATES]
FUNNEL	to pass through a cone-shaped utensil [v FUNNELLED or FUNNELED, FUNNELLING or FUNNELING, FUNNELS]
FUNNIEST	FUNNY, amusing [adj]
FURIOUSLY	FURIOUS, extremely angry [adv]
FURNISH	to equip [v -ED, -ING, -ES]
FURTHERMORE	in addition, also FARTHERMORE [adv]
FUTURE	the time yet to come [n -S]
GARBAGE	food waste [n -S]
GAZEBO	a roofed structure open at the sides [n -ES or -S]
GENERAL	widespread [adj GENERALLY] / to act as a military officer [v GENERALLED, GENERALLING, GENERALS]
GENEROSITY	the quality or fact of being generous [n GENEROSITIES]
GENIUS	(Latin) an exceptional natural aptitude [n GENIUSES or GENII]
GENTLE	to tame [v GENTLED, GENTLING, GENTLES] / mild and refined in manners [adj GENTLER, GENTLEST, GENTLY]
GEOMETRY	a branch of mathematics [n GEOMETRIES]
GESTURE	to express by bodily motion [v GESTURED, GESTURING, GESTURES]
GHOSTS	GHOST, to ghostwrite [v]
GHOUL	(Arabic) in Arabic mythology, a desert demon preying on travellers, also GHOULIE [n -S]
GIANT	a person or thing of great size [n -S]
GIN	to process cotton [v GINNED, GINNING, GINS] / (archaic) to begin [v GAN or (US) GUNNEN, GINNING, GINS]
GINGER	(Malay) to spice up, make spirited [v -ED, -ING, -S]
GIRAFFE	a long-necked mammal [n -S]
GLADIATOR	in ancient Rome, a professional combatant with men or wild animals in the arena [n -S]
GLANCE	to look quickly [v GLANCED or (obsolete) YGLAUNST, GLANCING, GLANCES]
GLORIOUS	magnificent [adj GLORIOUSLY]
GLUTINOUS	gluey; sticky [adj GLUTINOUSLY]
GNAT	any small fly of the family Culicidae, of which the females are commonly bloodsuckers [n -S]
GNAW	to wear away by persistent biting [v GNAWED, GNAWN, GNAWING, GNAWS]
GOVERNMENT	a group in a parliamentary system constituted by the cabinet or by the ministry [n -S]
GRABBED	GRAB, to grasp suddenly [v]
GRABBING	GRAB, to grasp suddenly [v]
GRACIOUS	marked by kindness and courtesy [adj GRACIOUSLY]
GRANDEUR	(French) impressive size [n -S]
GRANT	to bestow upon [v -ED, -ING, -S]
GRATITUDE	the state of being grateful [n -S]
GRIEF	intense mental stress [n -S]
GRIMACE	to contort the facial features [v GRIMACED, GRIMACING, GRIMACES]
GRUMBLE	to mutter in discontent [v GRUMBLED, GRUMBLING, GRUMBLES]
GUARD	to protect [v -ED, -ING, -S]
GUESS	to form an opinion from little or no evidence [v -ED, -ING, -ES]
GUILLOTINE	(French) an instrument for beheading consisting of a weighted blade allowed to drop between two tall grooved uprights [n -S] / to behead with a guillotine [v GUILLOTINED, GUILLOTINING, GUILLOTINES]
GUILTY	worthy of blame for an offence [adj GUILTIER, GUILTIEST, GUILTILY]
GYMKHANA	(Urdu) a sporting contest, esp. one involving riding or driving skills [n -S]
GYMNASIUM	a room for athletic activities [n GYMNASIUMS or GYMNASIA] / a continental school [n GYMNASIEN]
HALF	one of two equal parts [n HALVES] / a measure of whiskey [n HALFS]
HALLUCINATION	perception of objects with no reality usually arising from disorder of the nervous system or in response to drugs [n -S]
HALVES	HALVE, to divide into two equal parts [v]
HANGAR	to place in an aircraft shelter [v -ED, -ING, -S]
HAPPENED	HAPPEN, to occur [v]
HAPPIEST	HAPPY, marked by joy [adj]
HAPPILY	HAPPY, marked by joy [adv]
HAPPINESS	the state of being happy [n -ES]
HASTE	to hurry, also HASTEN [v HASTED, HASTING, HASTES]
HATCH	to bring forth young from an egg [v -ED, -ING, -ES]
HAUL	to pull with force [v -ED, -ING, -S]
HEAD	to be chief of [v -ED, -ING, -S]
HEALTH	sound physical or mental condition [n -S]
HEARD	herd [n -S]
HEAVIEST	HEAVY, of great weight [adj]
HEAVILY	HEAVY, of great weight [adv]
HEDGE	to enclose with a dense row of bushes [v HEDGED, HEDGING, HEDGES]
HEIRLOOM	an inherited possession [n -S]
HELIUM	a gaseous element [n -S]
HELMET	to supply with a protective covering for the head [v -ED, -ING, -S]
HERD	to bring together a group of animals [v -ED, -ING, -S]
HESITATED	HESITATE, to hold back or delay [v]
HESSIAN	a strong coarse cloth made of hemp or jute [n -S]
HILARIOUS	very amusing [adj HILARIOUSLY]
HISTORIC	important in history [adj HISTORICALLY]
HISTORY	to relate in a history or narrative [v HISTORIED, HISTORYING, HISTORIES]
HONEST	truthful [adj HONESTER, HONESTEST, HONESTLY]
HOPING	HOPE, to have a desire or expectation [v]
HOPPED	HOP, to move by jumping on one foot [v]
HOPPING	the harvesting of hops [n -S]
HORRENDOUS	fearful; frightful [adj HORRENDOUSLY]
HORRIBLY	HORRIBLE, dreadful [adv]
HORROR	intense repugnance or fear [n -S]
HOUSEHOLD	those who are held together in the same house, and compose a family [n -S]
HUMANITARIAN	a person promoting human welfare and social reform [n -S]
HUMBLE	to abase [v HUMBLED, HUMBLING, HUMBLES] / modest [adj HUMBLER, HUMBLEST, HUMBLY]
HUMMING	the noise of bees [n -S]
HURRIED	HURRY, to move swiftly [v]
HUTCH	a coop or cage for small animals [n -ES] / to hoard up [v -ED, -ING, -ES]
HYBRID	the offspring of genetically dissimilar parents [n -S]
HYGIENE	the science of preserving health [n -S]
ICE	to cover with frozen water [v ICED, ICING, ICES]
IDEA	a conception or a plan [n -S]
IGNITE	to set on fire [v IGNITED, IGNITING, IGNITES]
ILLEGAL	not legal [adj ILLEGALLY] / a person who enters a country without authorization [n -S]
ILLEGIBLE	not legible [adj ILLEGIBLY]
ILLOGICAL	not logical, also UNLOGICAL [adj ILLOGICALLY]
ILLUMINATE	to enlighten spiritually or intellectually [v ILLUMINATED, ILLUMINATING, ILLUMINATES]
ILLUSION	a false perception [n -S]
IMAGINABLE	that can be imagined [adj IMAGINABLY]
IMAGINARY	imagined [adj IMAGINARILY] / an imaginary quantity or expression [n IMAGINARIES]
IMAGINATION	the act of imagining [n -S]
IMAGINATIVE	characterized by imagination [adj IMAGINATIVELY]
IMAGINE	to form a mental picture of [v IMAGINED, IMAGINING, IMAGINES]
IMAGINED	IMAGINE, to form a mental picture of [v]
IMBALANCE	lack of balance [n -S]
IMMATURE	not mature [adj IMMATURER, IMMATUREST; IMMATURELY] / an immature animal [n -S]
IMMEDIATELY	IMMEDIATE, done or happening without delay [adv]
IMMORTAL	not subject to death [adj IMMORTALLY] / one who is not subject to death [n -S]
IMPENETRABLE	incapable of being penetrated or pierced [adj IMPENETRABLY]
IMPERCEPTIBLE	not perceptible [adj IMPERCEPTIBLY]
IMPERFECT	not perfect, also UNPERFECT [adj IMPERFECTER, IMPERFECTEST; IMPERFECTLY] / a verb tense expressing ongoing action in the past [n -S]
IMPERMEABLE	that cannot be permeated [adj]
IMPERVIOUS	not allowing entrance or passage, also IMPERVIABLE [adj IMPERVIOUSLY]
IMPLAUSIBLE	not plausible, also UNPLAUSIBLE [adj IMPLAUSIBLY]
IMPORTANT	of great import or consequence [adj IMPORTANTLY]
IMPROVISE	to compose and recite, or perform, without preparation [v IMPROVISED, IMPROVISING, IMPROVISES]
INACCESSIBLE	not accessible [adj INACCESSIBLY]
INACCURATE	not accurate [adj INACCURATELY]
INACTIVE	not active, also UNACTIVE [adj INACTIVELY]
INADEQUATE	not adequate [adj INADEQUATELY] / an incompetent person [n -S]
INCANDESCENT	white, glowing, or luminous with intense heat [adj INCANDESCENTLY] / a type of lightbulb [n -S]
INCAPABLE	not capable [adj INCAPABLY] / one who is in incapable [n -S]
INCOGNITO	(Italian) a man who is unknown or in disguise [n -S]
INCONSIDERABLE	not considerable [adj INCONSIDERABLY]
INCONSIDERATE	heedless, thoughtless [adj INCONSIDERATELY]
INCONSOLABLE	incapable of being consoled [adj INCONSOLABLY]
INCONVENIENT	not convenient esp. in giving trouble or annoyance [adj INCONVENIENTLY]
INCREASE	to become larger, also ENCREASE [v INCREASED, INCREASING, INCREASES]
INCREASED	INCREASE, to become larger, also ENCREASE [v]
INCREDIBLE	unbelievable, also UNCREDIBLE [adj INCREDIBLY]
INDECENT	not decent, also UNDECENT [adj INDECENTER, INDECENTEST, INDECENTLY]
INDEFINITE	of unlimited, or apparently unlimited number of extent [adj INDEFINITELY] / an indefinite thing [n -S]
INDEPENDENT	not committed to any group [adj INDEPENDENTLY] / one not committed to any group [n -S]
INDESTRUCTIBLE	incapable of being destroyed [adj INDESTRUCTIBLY]
INDIGESTION	inability to digest or difficulty in digesting something [n -S]
INDIVIDUAL	single [adj INDIVIDUALLY] / a single human being as contrasted with a social group or institution [n -S]
INDUSTRIAL	related to industry [adj INDUSTRIALLY] / one that is employed in industry [n -S]
INEXPERT	not expert, also UNEXPERT [adj INEXPERTLY] / one who lacks specific skills, also NONEXPERT [n -S]
INFECTIOUS	capable of causing infection [adj INFECTIOUSLY]
INFLUENTIAL	having great influence [adj INFLUENTIALLY] / one who has great influence [n -S]
INFORMATIVE	imparting knowledge [adj INFORMATIVELY]
INNOCENT	a person who is guileless [n -S] / free from moral wrong [adj INNOCENTER, INNOCENTEST, INNOCENTLY]
INSANITY	the state of being insane [n INSANITIES]
INSIDIOUS	developing or advancing gradually and imperceptibly [adj INSIDIOUSLY]
INSIGHT	a perception of the inner nature of things [n -S]
INSIGNIFICANT	not significant [adj INSIGNIFICANTLY]
INSINCERE	not sincere [adj INSINCERER, INSINCEREST; INSINCERELY]
INSIST	to maintain very firmly [v -ED, -ING, -S]
INSPIRE	to influence to greater heights [v INSPIRED, INSPIRING, INSPIRES]
INSTITUTE	to set up, establish [v INSTITUTED, INSTITUTING, INSTITUTES]
INSURANCE	the act, practice or business of insuring [n -S]
INTELLIGENT	having a high degree of intelligence [adj INTELLIGENTLY]
INTENTION	design, purpose [n -S]
INTERPRETER	one who translates orally for parties conversing in different languages [n -S]
INTERROGATE	to question formally and systematically [v INTERROGATED, INTERROGATING, INTERROGATES]
INTERRUPT	to break in between [v -ED, -ING, -S]
INTRAVENOUS	situated, performed, or occurring within or entering by way of a vein [adj INTRAVENOUSLY]
INTRIGUING	INTRIGUE, to arouse the curiosity of [v]
INTRUSION	the act of intruding [n -S]
INTUITION	the power of the mind by which it immediately perceives the truth of things without reasoning or analysis [n -S]
INVERTED	INVERT, to turn upside down [v]
INVOLUNTARY	done contrary to or without choice [adj INVOLUNTARILY]
IRIDESCENT	having or exhibiting iridescence [adj IRIDESCENTLY]
IRRATIONAL	not rational [adj IRRATIONALLY] / an irrational number [n -S]
IRREGULAR	not regular [adj IRREGULARLY] / a soldier not formally attached to a military body [n -S]
IRRELEVANT	not relevant [adj IRRELEVANTLY]
IRREVERSIBLE	not reversible [adj IRREVERSIBLY]
ISLAND	a mass of land (not a continent) surrounded with water [n -S] / to set or dot with or as with islands [v -ED, -ING, -S]
JARRAH	(Native Australian) the mahogany-like wood of an Australian eucalyptus [n -S]
JITTERY	extremely nervous [adj JITTERIER, JITTERIEST]
JOINT	combined [adj JOINTLY] / to fit together by means of a junction [v -ED, -ING, -S]
JOYSTICK	the control stick in an airplane [n -S]
JUDGE	to decide on critically [v JUDGED, JUDGING, JUDGES]
JUDICIAL	pertaining to courts of law [adj JUDICIALLY]
JURISDICTION	the power, right, or authority to interpret and apply the law [n -S]
JUROR	a member of a jury, also JURYMAN [n -S]
KALEIDOSCOPE	a variegated changing pattern or scene [n -S]
KAYAKING	the act of paddling a kayak [n -S]
KNEE	to strike with a joint of the leg [v KNEED, KNEEING, KNEES]
KNEEL	to rest on the knees [v KNELT or KNEELED, KNEELING, KNEELS]
KNICKERS	women's or girls' underpants; a woman's undergarment covering (and sometimes gathered in at) the thigh, also KNICKS [n]
KNIGHT	a man who has been awarded the rank immediately below baronet, with the title 'Sir' [n -S] / to confer the title of knight upon [v -ED, -ING, -S]
KNIGHTHOOD	the rank of a knight [n -S]
KNIVES	KNIVE, to knife [v]
KNOB	a rounded protuberance [n -S] / to knock off protuberances [v KNOBBED, KNOBBING, KNOBS]
KNOT	to tie with a closed loop [v KNOTTED, KNOTTING, KNOTS]
KNOWLEDGE	what is known [n -S] / (obsolete) to acknowledge [v KNOWLEDGED, KNOWLEDGING, KNOWLEDGES]
LABELLING	the act of attaching a tag to [n -S]
LABORATORY	a place equipped for experimental study in a science or for testing and analysis, also ELABORATORY [n LABORATORIES]
LABOURED	LABOUR, to work, also LABOR [v]
LACERATE	to tear roughly [v LACERATED, LACERATING, LACERATES]
LATCH	to close a gate with a catch [v -ED, -ING, -ES]
LAUGHING	mirthful [adj LAUGHINGLY] / the act of laughing [n -S]
LAUNDRY	a place where clothes are washed and ironed [n LAUNDRIES]
LAZIEST	LAZY, disinclined toward work or exertion [adj]
LEAGUE	to come together for a common purpose [v LEAGUED, LEAGUING, LEAGUES]
LEARN	to be informed [v LEARNED or LEARNT, LEARNING, LEARNS]
LEARNING	acquired knowledge [n -S]
LEATHER	to cover with the tanned hide of an animal [v -ED, -ING, -S]
LEDGE	a narrow, shelflike projection [n -S]
LEGISLATION	the action of legislating [n -S]
LEOPARD	a large, carnivorous, feline mammal [n -S]
LIAISE	to form a link with [v LIAISED, LIAISING, LIAISES]
LIAISON	(French) a means of maintaining communication [n -S]
LIGHTNING	to flash with lightning, a flash of light in the sky, caused by electricity being discharged from thunderclouds [v LIGHTNINGED, LIGHTNING, LIGHTNINGS]
LIKING	a feeling of affection [n -S]
LIQUEFY	to make or become liquid, also LIQUIFY [v LIQUEFIED, LIQUEFYING, LIQUEFIES]
LIQUEUR	a potent alcoholic preparation flavoured or perfumed and sweetened [n -S] / to flavour with a liqueur [v -ED, -ING, -S]
LISTENING	the act of trying to hear [n -S]
LITANY	a ceremonial form of prayer [n LITANIES]
LITERACY	the ability to read and write [n LITERACIES]
LITERATURE	the production of literary work esp. as an occupation [n -S]
LITIGATION	the act of litigating [n -S]
LIVELIHOOD	means of support or subsistence [n -S]
LOAVES	LOAVE, to form a head as in a cabbage [v]
LODGER	one who stays in rented accommodation [n -S]
LOGICAL	pertaining to logic [adj LOGICALLY]
LONELINESS	the state of being lonely [n -ES]
LONELY	sad from lack of companionship [adj LONELIER, LONELIEST, LONELILY]
LOVELIER	LOVELY, extremely beautiful [adj]
LOVELIEST	LOVELY, extremely beautiful [adj]
LOVELY	a beautiful woman [n LOVELIES] / extremely beautiful [adj LOVELIER, LOVELIEST, LOVELILY]
LUCKIER	LUCKY, fortunate [adj]
LUCKILY	LUCKY, fortunate [adv]
LUCRATIVE	yielding lucre; profitable [adj LUCRATIVELY]
LUNACY	insanity [n LUNACIES]
LUNAR	the distance of the moon as used for navigation [n -S]
LUSCIOUS	having a delicious taste [adj LUSCIOUSLY]
LUXURIANT	overabundant in growth [adj LUXURIANTLY]
LYREBIRD	an Australian bird, that spreads its tail like a lyre during courtship [n -S]
MACAW	a large tropical American parrot, having a long tail and brilliant plumage [n -S]
MAGNIFICENT	splendid [adj MAGNIFICENTLY]
MAKING	material from which something can be developed [n -S]
MANAGEABLE	that can be managed [adj MANAGEABLY]
MANDATORY	by mandate, also MANDATARY [adj MANDATORILY] / the holder of a mandate [n MANDATORIES]
MANGROVE	any of various tropical trees or shrubs with interlacing aerial roots [n -S]
MANIFEST	clear, obvious [adj MANIFESTLY] / to show clearly [v -ED, -ING, -S]
MANUFACTURE	to make into a product suitable for use [v MANUFACTURED, MANUFACTURING, MANUFACTURES]
MANUFACTURED	MANUFACTURE, to make into a product suitable for use [v]
MANUFACTURING	the manufacturing section of industry [n -S]
MARJORAM	any of various labiate plants of the genus Origanum, aromatic herbs much used in cooking [n -S]
MARTIAL	pertaining to war [adj MARTIALLY] / a court martial [n -S]
MARVELLOUS	astonishing, very pleasing, also MARVELOUS [adj MARVELLOUSLY]
MASONRY	the craft of a mason; stonework or brickwork [n MASONRIES]
MASSEUR	(French) a male who makes a living by giving massage [n -S]
MATCH	to be equal to [v -ED, -ING, -ES]
MATERIAL	relevant [adj MATERIALLY] / the substance of which anything is or may be composed [n -S]
MATRIARCH	a woman who is the head of a family [n -S]
MATTED	MAT, to tangle closely [v]
MAYOR	the chief executive official of a city or borough [n -S]
MEASURED	MEASURE, to compare with a standard [v]
MECHANIC	a person who works with machines [n -S]
MEDICAL	related to medicine [adj MEDICALLY] / a medical examination [n -S]
MEDICALLY	MEDICAL, related to medicine [adv]
MEDICINE	to treat with a substance to heal, prevent or cure [v MEDICINED, MEDICINING, MEDICINES]
MEDIEVAL	belonging to the Middle Ages, also MEDIAEVAL [adj MEDIEVALLY] / a person who lived in the Middle Ages [n -S]
MEMBERSHIP	the state or status of being a member [n -S]
MEMORIES	MEMORY, the gift of being able to retain and recall events [n]
MENTALLY	MENTAL, pertaining to the mind [adv]
MERCURY	a metallic element [n MERCURIES]
MERIT	to deserve [v -ED, -ING, -S]
MERRIER	MERRY, mirthful, also MERRIE [adj]
MERRILY	MERRY, mirthful, also MERRIE [adv]
METROPOLIS	the chief or capital city of a country, state, or region [n -ES]
MILLION	a thousand thousand [n -S]
MIRACULOUS	of the nature of a miracle [adj MIRACULOUSLY]
MISCELLANEOUS	consisting of diverse things or members [adj MISCELLANEOUSLY]
MISCHIEF	petty misdeeds [n -S] / to make mischief [v -ED, -ING, -S]
MISCHIEVOUS	given to mischief [adj MISCHIEVOUSLY]
MISERABLE	wretched [adj MISERABLY] / a miserable person, a wretch [n -S]
MISERABLY	MISERABLE, wretched [adv]
MISFORTUNE	an event or conjunction of events that causes an unfortunate or distressing result [n -S]
MISGUIDED	MISGUIDE, to guide wrongly [v]
MISJUDGE	to judge wrongly [v MISJUDGED, MISJUDGING, MISJUDGES]
MISOGYNY	a hatred of women [n MISOGYNIES]
MISSION	to send to perform a specific task [v -ED, -ING, -S]
MISSIVE	a written communication [n -S]
MISTLETOE	a Eurasian evergreen shrub, with leathery leaves, yellowish flowers, and waxy white berries, grows as a partial parasite on various trees, also MISLETOE [n -S]
MIXTURE	the product of mixing [n -S]
MODERN	pertaining to the present time [adj MODERNER, MODERNEST, MODERNLY] / a person with up to date views [n -S]
MODICUM	(Latin) a small amount [n MODICUMS or MODICA]
MONOTONOUS	uttered or sounded in one unvarying tone [adj MONOTONOUSLY]
MOUNTAIN	a large, natural elevation of the earth's surface [n -S]
MOUSSE	(French) to apply a kind of hairstyling lotion [v MOUSSED, MOUSSING, MOUSSES]
MUSCLE	to force one's way [v MUSCLED, MUSCLING, MUSCLES]
MUSEUM	a repository for the collection, exhibition and study of objects [n -S]
MUSICIANS	MUSICIAN, one who performs or composes music [n]
MYSTERIOUS	of, relating to, or constituting mystery [adj MYSTERIOUSLY]
MYTH	a type of traditional story, also MYTHOS, MYTHUS [n -S]
NAIVETY	the quality of being naive, also NAIVETE [n NAIVETIES]
NASTIER	NASTY, ill-natured [adj]
NASTINESS	the state of being nasty [n -ES]
NATIONAL	belonging to a nation [adj NATIONALLY] / a citizen of a nation [n -S]
NAVIGATOR	a person who navigates or sails [n -S]
NECESSARY	needed [adj NECESSARILY] / something necessary [n NECESSARIES]
NECESSITATE	to make necessary [v NECESSITATED, NECESSITATING, NECESSITATES]
NEGLIGENT	careless [adj NEGLIGENTLY]
NERVOUS	easily excited [adj NERVOUSLY]
NICE	agreeable; precise [adj NICER, NICEST, NICELY]
NICHE	to place in a hollow [v NICHED, NICHING, NICHES]
NIECE	a daughter of one's brother of sister [n -S]
NOISIER	NOISY, making loud sounds [adj]
NONCHALANT	having an air of easy unconcern or indifference [adj NONCHALANTLY]
NORMALITY	the state of being normal [n NORMALITIES]
NORMALLY	NORMAL, usual [adv]
NOTICING	NOTICE, to become aware of [v]
NUMB	lacking feeling [adj NUMBER, NUMBEST, NUMBLY] / to deprive of feeling [v -ED, -ING, -S]
NUMBED	NUMB, to deprive of feeling [v]
NUTRITION	the act of nourishing; food [n -S]
OBEDIENCE	the act or practice of doing what one is told [n -S]
OBSCURE	indistinct [adj OBSCURER, OBSCUREST, OBSCURELY] / to make indistinct [v OBSCURED, OBSCURING, OBSCURES]
OBSERVANT	carefully attentive [adj OBSERVANTLY] / a person who observes a law, custom etc. [n -S]
OBSERVATION	an act or instance of observing a custom, rule, or law [n -S]
OBSERVE	to look attentively [v OBSERVED, OBSERVING, OBSERVES]
OBSESSIVE	subject to obsession [adj OBSESSIVELY] / someone affected or characterized by obsessive behaviour [n -S]
OBTAIN	to gain possession of [v -ED, -ING, -S]
OBTAINED	OBTAIN, to gain possession of [v]
OBVIOUS	easily understood [adj OBVIOUSLY]
OBVIOUSLY	OBVIOUS, easily understood [adv]
OCCASIONAL	of or relating to a particular occasion [adj OCCASIONALLY]
OCCASIONS	OCCASION, to cause [v]
OCCUR	to take place [v OCCURRED, OCCURRING, OCCURS]
ODDITY	one that is odd [n ODDITIES]
ODOR	any smell, whether fragrant or offensive, also ODOUR [n -S]
ONSLAUGHT	an attack [n -S]
OPPORTUNITY	a favorable juncture of circumstances [n OPPORTUNITIES]
OPPOSITION	the act of opposing [n -S]
OPTICAL	pertaining to sight [adj OPTICALLY]
OPTICIAN	one who deals in optical goods [n -S]
OPTIMIST	one who exhibits optimism [n -S]
OPTION	to grant the act of choosing [v -ED, -ING, -S]
ORCHESTRA	a large company of musicians (strings, woodwind, brass, and percussion) playing together under a conductor [n -S]
OREGANO	(Spanish) wild marjoram, also ORIGAN, ORIGANE, ORIGANUM [n -S]
ORGANIC	relating to living matter, also ORGANICAL [adj ORGANICALLY] / an organic substance [n -S]
ORGANIZE	to form into an organic whole, also ORGANISE [v ORGANIZED, ORGANIZING, ORGANIZES]
ORIGAMI	(Japanese) the art of paper folding [n -S]
ORIGINALLY	ORIGINAL, relating to the origin [adv]
ORPHAN	to deprive of both parents [v -ED, -ING, -S]
PAPYRUS	(Latin) a parchment made from reeds [n PAPYRI or PAPYRUSES]
PARANOIA	a mental disorder, also PARANOEA [n -S]
PARCEL	to divide into parts or shares [v PARCELED or PARCELLED, PARCELING or PARCELLING, PARCELS]
PARENTHESIS	an amplifying or explanatory word, phrase, or sentence inserted in a passage from which it is usually set off by punctuation [n PARENTHESES]
PARLIAMENTARIAN	an adherent of the parliament in opposition to the king during the English Civil War [n]
PARTICIPATION	the act of participating [n -S]
PASSAGE	to make a voyage [v PASSAGED, PASSAGING, PASSAGES]
PATIENT	calm and uncomplaining [adj PATIENTER, PATIENTEST, PATIENTLY] / (Shakespeare) to make calm and uncomplaining [v -ED, -ING, -S]
PATROLLED	PATROL, to guard by moving and watching [v]
PECULIAR	strange [adj PECULIARLY] / a parish or church exempt from the jurisdiction of the diocese in which it lies [n -S]
PEDESTAL	to provide with an architectural support [v PEDESTALED or PEDESTALLED, PEDESTALING or PEDESTALLING, PEDESTALS]
PERCEIVE	to become aware of through the senses [v PERCEIVED, PERCEIVING, PERCEIVES]
PERILOUS	dangerous, also PARLOUS, PERICULOUS, PERLOUS [adj PERILOUSLY]
PERIMETER	the circuit or boundary of any plane figure [n -S]
PERMANENT	remaining, or intended to remain, indefinitely [adj PERMANENTLY] / a permanent member of staff [n -S]
PERMISSION	the act of permitting [n -S]
PERMITTED	PERMIT, to allow [v]
PERSIMMON	a kind of plumlike fruit [n -S]
PERSONAL	related to oneself [adj PERSONALLY] / an advertisement or notice in the personal column of a newspaper [n -S]
PERSONALITIES	PERSONALITY, the state of being a person [n]
PERSUADE	to induce by reasoning or entreaty, also PERSWADE [v PERSUADED, PERSUADING, PERSUADES]
PERSUASION	the act of persuading [n -S]
PETTICOAT	a skirt, esp. an underskirt, or a garment of which it forms part [n -S]
PHENOMENON	anything directly apprehended by the senses or one of them, also PHAENOMENON [n PHENOMENA or PHENOMENONS]
PHONEY	counterfeit, fake [adj PHONIER, PHONIEST, PHONILY] / to fake, counterfeit [v -ED, -ING, -S]
PHOTOCOPY	a photographic reproduction of written matter, etc. [n PHOTOCOPIES] / to make a photocopy of [v PHOTOCOPIED, PHOTOCOPYING, PHOTOCOPIES]
PHOTOGRAPH	to take a photograph of [v -ED, -ING, -S]
PHOTOGRAPHS	PHOTOGRAPH, to take a photograph of [v]
PHYSICAL	related to the body [adj PHYSICALLY] / a physical examination [n -S]
PICTURE	to form a likeness of [v PICTURED, PICTURING, PICTURES]
PIERCE	to thrust, or make a hole through [v PIERCED, PIERCING, PIERCES]
PIONEER	someone who is among the first in new fields of enterprise, exploration etc., also PIONER, PYONER [n -S] / to take part in the beginnings of [v -ED, -ING, -S]
PLACE	to assign to a position [v PLACED or (obsolete) PLAST, PLASTE or YPLAST, PLACING, PLACES]
PLAINTIFF	a person or body suing a defendant in a court of law [n -S]
PLANNED	PLAN, to formulate an idea [v]
PLATEAU	(French) a level stretch of elevated land [n PLATEAUS or PLATEAUX] / to reach a period of stability [v -ED, -ING, -S]
PLOUGH	to turn soil with a farm implement, also PLOW [v -ED, -ING, -S]
POINT	to indicate direction with the finger [v -ED, -ING, -S]
POKING	POKE, to prod [v]
POLITE	showing consideration for others [adj POLITER, POLITEST, POLITELY]
PONTOON	a flat-bottomed boat or barge, also PONTON [n -S] / to cross with a pontoon [v -ED, -ING, -S]
POPPED	POP, to make a sharp, small, explosive sound [v]
PORPOISE	a short-snouted genus of the dolphin family, also PORPESS, PORPESSE [n -S] / to move like a porpoise; specifically (of an aircraft, esp. a seaplane) to touch the water or ground and rise again [v PORPOISED, PORPOISING, PORPOISES]
PORTABLE	able to be carried [adj PORTABLY] / something e.g. a computer which is portable [n -S]
POSSESSION	the act of having or taking into control [n -S]
POSSIBLY	capable of happening or proving true [adj]
POTENTIAL	latent, possible or likely [adj POTENTIALLY] / powers or resources not yet developed or made use of [n -S]
POULTRY	farmyard fowls collectively [n POULTRIES]
POWERFULLY	POWERFUL, full of power [adv]
PRACTICAL	relating to actual practice [adj PRACTICALLY] / a practical examination [n -S]
PRACTISED	PRACTISE, to train or drill in order to acquire skill, also PRACTICE [v]
PRACTISING	PRACTISE, to train or drill in order to acquire skill, also PRACTICE [v]
PRECARIOUS	insecure, uncertain [adj PRECARIOUSLY]
PRECISE	sharply and clearly defined or stated [adj PRECISER, PRECISEST, PRECISELY]
PREDATORS	PREDATOR, an animal that preys on another [n]
PREDICTED	PREDICT, to tell of or about in advance [v]
PREDICTOR	one who predicts, also PREDICTER [n -S]
PREFABRICATE	to make standardized parts of beforehand, for assembling later [v PREFABRICATED, PREFABRICATING, PREFABRICATES]
PRELIMINARY	preceding [adj PRELIMINARILY] / something that precedes or is introductory or preparatory [n PRELIMINARIES]
PREPARATION	the act of preparing [n -S]
PRESENCE	close proximity [n -S]
PRESIDENT	the head of a state, board, council etc. [n -S]
PREVIOUS	coming or occurring before in time or order [adj PREVIOUSLY]
PREY	to exploit or terrorize victims [v -ED, -ING, -S]
PRIORITIZE	to assign a priority to, also PRIORITISE [v PRIORITIZED, PRIORITIZING, PRIORITIZES]
PRIVILEGED	PRIVILEGE, to grant a privilege to [v]
PROBABLE	likely to occur or prove true [adj PROBABLY] / something probable [n -S]
PROCEED	to go onward [v -ED, -ING, -S]
PRODIGY	a child with exceptional talent and ability [n PRODIGIES]
PROFESSOR	a university or college teacher of the highest grade [n -S]
PROFITEER	a person who takes advantage of an emergency to make exorbitant profits [n -S] / to act as a profiteer [v -ED, -ING, -S]
PROGRAMME	to prepare a program for (a computer, etc.) [v PROGRAMMED, PROGRAMMING, PROGRAMMES]
PROGRESSION	motion onward [n -S]
PROPORTION	to adjust (a part or thing) in size relative to other parts or things [v -ED, -ING, -S]
PROTECTION	the act of protecting [n -S]
PROVISO	(Latin) a clause in a document containing a condition [n -S or -ES]
PUMPKIN	a plant of the gourd family, or its fruit, also POMPION, PUMPION, PUNKIN [n -S]
PUNCTURE	to pierce with a pointed object [v PUNCTURED, PUNCTURING, PUNCTURES]
PUNCTURED	PUNCTURE, to pierce with a pointed object [v]
PURE	free from stain [adj PURER, PUREST, PURELY] / to cleanse or refine; to treat with pure (dog faeces) [v PURED, PURING, PURES]
PUREST	PURE, free from stain [adj]
PURIST	one who practises purism [n -S]
PYLON	a structure for supporting power-cables [n -S]
QUALITY	persons of the upper class collectively [n QUALITIES]
QUANTITY	a certain number [n QUANTITIES]
QUAY	a wharf for the loading or unloading of vessels [n -S]
QUENCH	to put out or extinguish [v -ED, -ING, -ES]
QUERY	to question [v QUERIED, QUERYING, QUERIES]
QUEUE	to line up for service [v QUEUED, QUEUEING, QUEUES]
QUIBBLE	to argue over petty matters [v QUIBBLED, QUIBBLING, QUIBBLES]
QUICK	acting or capable of acting with speed [adj QUICKER, QUICKEST, QUICKLY] / a sensitive area of flesh [n -S]
QUICKLY	QUICK, acting or capable of acting with speed [adv]
QUIETLY	QUIET, making little or no noise [adv]
QUIT	to end one's engagement in or occupation with, also QUIGHT, QUITE, QUYTE [v QUIT or QUITTED, QUITTING, QUITS]
QUOTATION	something quoted [n -S]
RACQUET	a bat with strings used for hitting balls [n -S] / to strike with a racquet [v -ED, -ING, -S]
RADIATOR	a heating device [n -S]
RAISE	to move to a higher position [v RAISED, RAISING, RAISES]
RAISIN	(French) a dried grape [n -S]
RANCOUR	bitter and vindictive enmity, also RANCOR [n -S]
RANGE	to place in a particular order, also RAUNGE [v RANGED, RANGING, RANGES]
RASPBERRY	the fruit of Rubus idaeus [n RASPBERRIES]
RAVENOUS	extremely hungry [adj RAVENOUSLY]
RAVINE	a narrow, steep-sided valley [n -S]
REACTION	the act of reacting [n -S]
READ	to look at and understand written matter [v READ, READING, READS]
REALISTICALLY	REALISTIC, resembling reality, lifelike [adv]
REALM	a kingdom, also REAME [n -S]
REBELLIOUS	given to or engaged in rebellion [adj REBELLIOUSLY]
RECEIPT	to mark as having been paid [v -ED, -ING, -S]
RECEIVE	to come into possession of [v RECEIVED, RECEIVING, RECEIVES]
RECEIVED	RECEIVE, to come into possession of [v]
RECENT	happening not long ago [adj RECENTER, RECENTEST, RECENTLY]
RECEPTION	the act of receiving or of being received [n -S]
RECIPE	a set of instructions for making something [n -S]
RECIPIENT	one who receives [n -S]
RECOGNIZE	to identify as known or experienced before, also RECOGNISE [v RECOGNIZED, RECOGNIZING, RECOGNIZES]
RECOMMEND	to commend or introduce as suitable for acceptance [v -ED, -ING, -S]
RECOUP	to get back the equivalent of [v -ED, -ING, -S]
RECTANGULAR	shaped like a rectangle [adj RECTANGULARLY]
REFERENCE	to refer to [v REFERENCED, REFERENCING, REFERENCES]
REFLECT	to be mirrored [v -ED, -ING, -S]
REFLECTION	an image given back by a reflecting surface [n -S]
REFUSED	REFUSE, to decline to take or accept [v]
REGATTA	(Italian) a rowing or sailing competition [n -S]
REGIMENT	a large permanent unit within an army [n -S] / to form into military units [v -ED, -ING, -S]
REHEARSING	the act of rehearsing [n -S]
REIGN	to exercise sovereign power [v -ED, -ING, -S]
REINFORCE	to strengthen with new force, assistance, material, or support, also REENFORCE, RENFORCE [v REINFORCED, REINFORCING, REINFORCES]
REJOICE	to feel joyful [v REJOICED, REJOICING, REJOICES]
REJUVENATE	to make young again [v REJUVENATED, REJUVENATING, REJUVENATES]
RELATIVITY	the state of being relative [n RELATIVITIES]
RELIABLE	dependable [adj RELIABLY] / something, e.g. a car, that is reliable [n -S]
RELIANCE	confident or trustful dependence [n -S]
RELIEF	aid in the form of money or necessities [n -S]
RELIVING	RELIVE, to experience again [v]
REMAIN	to continue in the same state [v -ED, -ING, -S]
REMAINED	REMAIN, to continue in the same state [v]
REMEDY	to relieve or cure [v REMEDIED, REMEDYING, REMEDIES]
REMITTANCE	a sum of money remitted [n -S]
REMNANT	something remaining, also REMANENT [n -S]
REMORSE	deep anguish caused by a sense of guilt [n -S]
REPAIR	to restore to good condition [v -ED, -ING, -S]
REPAIRED	REPAIR, to restore to good condition [v]
REPLENISH	to fill again, also PLENISH [v -ED, -ING, -ES]
REPLIED	REPLY, to answer [v]
REPLIES	REPLY, to answer [v]
RESEARCH	to investigate thoroughly [v -ED, -ING, -ES]
RESEARCHED	RESEARCH, to investigate thoroughly [v]
RESENTFUL	full of resentment, also RESENTIVE [adj RESENTFULLY]
RESIDENTIAL	used as a residence or by residents [adj RESIDENTIALLY]
RESISTANT	making resistance [adj] / a person who or thing which resists; specifically a member of a resistance movement, also RESISTENT [n -S]
RESOURCE	to provide for [v RESOURCED, RESOURCING, RESOURCES]
RESOURCES	RESOURCE, to provide for [v]
RESURRECT	to bring back to life [v -ED, -ING, -S]
RESUSCITATE	to revive from apparent death or from unconsciousness [v RESUSCITATED, RESUSCITATING, RESUSCITATES]
RETICENT	tending to be silent [adj RETICENTLY]
RHYME	to compose verse with corresponding terminal sounds, also RIME [v RHYMED, RHYMING, RHYMES]
RIDGE	to form into long, narrow elevations [v RIDGED, RIDGING, RIDGES]
RIGMAROLE	a succession of incoherent statements, also RIGAMAROLE [n -S]
RIGOROUS	characterized by rigor [adj RIGOROUSLY]
ROBBER	one that robs [n -S]
ROGUE	to cheat or defraud [v ROGUED, ROGUEING or ROGUING, ROGUES]
ROMANCE	to woo [v ROMANCED, ROMANCING, ROMANCES]
RUBBED	RUB, to apply friction [v]
RUMMAGE	to search thoroughly through [v RUMMAGED, RUMMAGING, RUMMAGES]
RUMOR	to spread by hearsay, also RUMOUR [v -ED, -ING, -S]
RUNNER	one who runs [n -S]
RUSTIER	RUSTY, covered with rust [adj]
RUSTIEST	RUSTY, covered with rust [adj]
SABOTAGE	to destroy maliciously [v SABOTAGED, SABOTAGING, SABOTAGES]
SAFARI	(Swahili) a hunting expedition, also SUFFARI [n -S] / to go on a hunting expedition [v -ED, -ING, -S]
SAFETY	to protect against failure, breakage or accident [v SAFETIED, SAFETYING, SAFETIES]
SAILOR	a member of a ship's crew [n -S]
SAMURAI	(Japanese) a member of the military caste in feudal Japan [n -S]
SANDWICH	to place between two objects [v -ED, -ING, -ES]
SARCASM	a sharply mocking or contemptuous remark [n -S]
SATELLITE	a body revolving around a planet, also SATELLES [n -S] / to transmit by satellite [v SATELLITED, SATELLITING, SATELLITES]
SATISFIES	SATISFY, to provide fully for [v]
SAUSAGE	finely chopped and seasoned meat in a casing [n -S]
SAXOPHONE	a jazz and dance band instrument with a reed, an S-shaped (properly metal) tube, and about twenty finger-keys [n -S]
SCAFFOLDING	a framework of platforms for painters [n -S]
SCAPULA	(Latin) a bone in the shoulder [n SCAPULAS or SCAPULAE]
SCARVES	SCARF, a piece of cloth worn for warmth or protection [n]
SCHNITZEL	(German) a thin veal cutlet fried in butter [n -S]
SCINTILLATE	to sparkle [v SCINTILLATED, SCINTILLATING, SCINTILLATES]
SCISSORS	SCISSOR, to cut with a two-bladed instrument [v]
SCRAPING	something scraped off [n -S]
SCRUPULOUS	having moral integrity, acting in strict regard for what is considered right or proper [adj SCRUPULOUSLY]
SCULPTOR	one who sculpts [n -S]
SCURRIED	SCURRY, to move hurriedly, also SKURRY [v]
SEARCH	to look carefully for something [v -ED, -ING, -ES]
SEARCHING	the act of conducting a search [n -S]
SECONDARY	subordinate [adj SECONDARILY] / a subordinate [n SECONDARIES]
SECRETARY	a person who types and deals with correspondence, and does general clerical and administrative work for a company or individual [n SECRETARIES]
SECRETIVELY	SECRETIVE, inclined to or fond of secrecy [adv]
SEIZE	to take hold of suddenly and forcibly, also SEISE [v SEIZED, SEIZING, SEIZES]
SELVES	SELF, one's own person [n]
SENSATIONAL	of or relating to sensation or the senses [adj SENSATIONALLY]
SEPARATION	the act of separating [n -S]
SEQUIN	to apply shiny ornamental disks to [v SEQUINNED or SEQUINED, SEQUINING, SEQUINS]
SERVIETTE	(French) a table-napkin, esp. a paper one [n -S]
SESSION	a period of time spent on any one activity [n -S]
SEWAGE	the waste matter carried off by sewers, also SEWERAGE [n -S]
SHAKING	the act of shaking [n -S]
SHOVELING	SHOVEL, to use a digging implement [v]
SHREDDER	a machine that shreds [n -S]
SHRIEK	to utter a scream, also SCRIKE, SHREEK, SHREIK, SHRIECH, SHRIKE, SHRITCH, SKRIKE [v -ED, -ING, -S]
SHRUGGING	SHRUG, to raise and contract the shoulders [v]
SIGN	to write one's name [v -ED, -ING, -S]
SIGNAL	notable [adj SIGNALLY] / to make a sign [v SIGNALED or SIGNALLED, SIGNALING or SIGNALLING, SIGNALS]
SIGNATURE	a signing, a signed name [n -S]
SINCERELY	SINCERE, free from hypocrisy or falseness [adv]
SKELETON	the supporting bone structure of a body [n -S]
SKEPTICAL	inclined to questioning and disbelief, also SCEPTICAL [adj SKEPTICALLY]
SKIPPING	flighty, giddy [adj SKIPPINGLY] / the act of skipping [n -S]
SKULK	to move about stealthily, also SCULK [v -ED, -ING, -S]
SLEDGE	to convey on a type of sled [v SLEDGED, SLEDGING, SLEDGES]
SLIDING	the act of sliding [n -S]
SLIMMING	the act of slimming [n -S]
SLOUCH	to sit, stand, or move with a drooping posture [v -ED, -ING, -ES]
SMUDGE	to smear or dirty [v SMUDGED, SMUDGING, SMUDGES]
SOCIABLE	gregarious [adj SOCIABLY] / a four-wheeled open carriage with side-seats [n -S]
SOLDIER	to perform military service [v -ED, -ING, -S]
SOUGHT	SEEK, to go in search of [v]
SOUVENIR	a remembrance [n -S] / to provide a souvenir of [v -ED, -ING, -S]
SPACE	to arrange at intervals apart [v SPACED, SPACING, SPACES]
SPATULA	(Latin) a broad, blunt, flexible blade or flattened spoon, also SPATULE [n -S]
SPECIFIC	for a particular purpose, also SPECIFICAL [adj SPECIFICALLY] / a remedy intended for a particular disease [n -S]
SPHERE	to form into a type of geometric solid circle [v SPHERED, SPHERING, SPHERES]
SPINNER	one that spins [n -S]
SPITEFUL	malicious [adj SPITEFULLER, SPITEFULLEST, SPITEFULLY]
SPLODGE	to make a splash, also SPLATCH, SPLOTCH [v SPLODGED, SPLODGING, SPLODGES]
SPOILT	SPOIL, to mar [v]
SPREAD	to stretch over an area [v SPREAD or (obsolete) SPRAD, SPRED, SPREDD or SPREDDE, SPREADING, SPREADS]
SQUALL	to rain or blow with sudden strength [v -ED, -ING, -S]
STAMMERED	STAMMER, to speak with involuntary breaks and pauses [v]
STAMPEDE	to send rushing in panic, also STAMPEDO [v STAMPEDED, STAMPEDING, STAMPEDES]
STATEMENT	something said formally [n -S] / to take a statement [v -ED, -ING, -S]
STATIONERY	materials (as paper, pens, and ink) for writing or typing [n STATIONERIES]
STEPPING	STEP, to measure by pacing [v]
STOPPING	the action of one who stops [n -S]
STRANGELY	STRANGE, unusual or unfamiliar, also STRAUNGE [adv]
STRENGTH	a degree of being mentally or physically strong [n -S]
SUBURB	a residential area adjacent to a city [n -S]
SUCCESSFULLY	SUCCESSFUL, resulting or terminating in success [adv]
SUICIDE	to kill oneself intentionally [v SUICIDED, SUICIDING, SUICIDES]
SUITABLE	appropriate [adj SUITABLY]
SUITE	(French) a series of things forming a unit [n -S]
SUMMONED	SUMMON, to order to appear [v]
SUPERSONIC	above the speed of sound [adj SUPERSONICALLY] / a supersonic wave or frequency [n -S]
SUPERVISION	the act of supervising [n -S]
SUPPLIES	SUPPLY, to provide with service or goods [v]
SURELY	SURE, certain [adv]
SUSCEPTIBLE	open to the influence of [adj SUSCEPTIBLY]
SUSPICIOUS	tending to arouse suspicion [adj SUSPICIOUSLY]
SUSPICIOUSLY	SUSPICIOUS, tending to arouse suspicion [adv]
SWAB	to clean with a large mop, also SWOB [v SWABBED, SWABBING, SWABS]
SWIMMER	one that swims [n -S]
SWITCH	to beat with a flexible rod [v -ED, -ING, -ES]
SWOLLEN	SWELL, to increase in size or volume [v]
SWORD	a weapon with a long blade [n -S] / to wield a sword [v -ED, -ING, -S]
SYLLABLE	to pronounce units of spoken language [v SYLLABLED, SYLLABLING, SYLLABLES]
SYSTEM	a group of interacting elements forming a unified whole [n -S]
TALONS	TALON, a hooked claw or finger, also TALANT, TALAUNT [n]
TAMBOURINE	a shallow single-headed drum with jingles fitted round its rim, played on by beating or tapping with the hand, also TAMBURIN [n -S]
TANGERINE	a mandarin orange, esp. a small, flattish, loose-skinned variety [n -S]
TAUGHT	TEACH, to impart knowledge or skill to [v]
TAUNT	to goad or provoke [v -ED, -ING, -S]
TECHNOLOGY	the practical application of knowledge esp. in a particular area [n TECHNOLOGIES]
TEDIOUS	causing weariness [adj TEDIOUSLY]
TELEKINESIS	the production of motion in objects (as by a spiritualistic medium) without contact or other physical means [n TELEKINESES]
TELEPHONED	TELEPHONE, to contact someone by telephone [v]
TEMPESTUOUS	of or like a tempest [adj TEMPESTUOUSLY]
TEMPURA	(Japanese) a dish of vegetables and shrimp dipped in batter and deep-fried [n -S]
TENANT	a person who occupies property owned by another, in return for rent, service, etc. [n -S] / to occupy as tenant [v -ED, -ING, -S]
TENSION	to make strained [v -ED, -ING, -S]
TENTACLE	a slender flexible organ in invertebrates [n -S]
TERRITORY	possessions in land; the whole, or a portion, of the land belonging to a state [n TERRITORIES]
TEXTURE	to make by weaving [v TEXTURED, TEXTURING, TEXTURES]
THATCH	to cover with plant stalks or foliage [v -ED, -ING, -ES]
THERAPEUTIC	related to the healing arts, also THERAPEUTICAL [adj THERAPEUTICALLY]
THIEVE	to steal [v THIEVED, THIEVING, THIEVES]
THOROUGH	complete, also THORO [adj THOROUGHER, THOROUGHEST, THOROUGHLY] / a manmade channel; a drainage ditch [n -S]
THOROUGHLY	THOROUGH, complete, also THORO [adv]
THOUGH	despite the fact that [conj]
THOUGHTFUL	absorbed in thought [adj THOUGHTFULLY]
THRESHOLD	the sill of a house door; the place or point of entering [n -S]
THUMB	to leaf through with the short, thick digit of the hand [v -ED, -ING, -S]
TIDIED	TIDY, to make tidy [v]
TOLERANT	inclined to tolerate [adj TOLERANTLY]
TONGUE	to touch with the fleshy organ of the mouth [v TONGUED, TONGUING, TONGUES]
TOPOGRAPHIC	relating to topography, also TOPOGRAPHICAL [adj TOPOGRAPHICALLY]
TORCH	to set on fire [v -ED, -ING, -ES]
TOTALING	TOTAL, to amount to [v]
TOTALLY	TOTAL, whole [adv]
TOUR	to travel from place to place [v -ED, -ING, -S]
TOURNAMENT	a series of games to determine a winner or winning team by elimination [n -S]
TRADITIONALLY	TRADITIONAL, relating to or derived from tradition [adv]
TRAMPOLINE	(tradename) a springy mat for bouncing on, also TRAMPOLIN [n -S] / to use a trampoline [v TRAMPOLINED, TRAMPOLINING, TRAMPOLINES]
TRANSCEND	to surpass; to exceed [v -ED, -ING, -S]
TRANSFUSION	the act of transfusing esp. blood [n -S]
TRANSITORY	not lasting long [adj TRANSITORILY]
TRANSLUCENT	imperfectly transparent, also TRANSLUCID [adj TRANSLUCENTLY]
TRAPPING	a covering for a horse [n -S]
TRAUMA	(Greek) a severe emotional shock [n TRAUMAS or TRAUMATA]
TRAVELED	TRAVEL, to go from one place to another [v]
TRAVELING	the act of travel [n -S]
TREASON	betrayal of one's country [n -S]
TREASURED	TREASURE, to value highly [v]
TRESPASS	to enter unlawfully on the premises of another [v -ED, -ING, -ES]
TRIED	TRIE, (Spenser) to try [v]
TRIUMPH	to be victorious [v -ED, -ING, -S]
TROWEL	to smooth with a tool with a flat blade [v TROWELED or TROWELLED, TROWELING or TROWELLING, TROWELS]
TRUDGE	to walk tiredly [v TRUDGED, TRUDGING, TRUDGES]
TRUTHFULLY	TRUTHFUL, telling the truth [adv]
TUITION	a fee for instruction [n -S]
TWINGE	to affect with a sharp pain [v TWINGED, TWINGEING or TWINGING, TWINGES]
TYPHOON	(Chinese) a tropical hurricane [n -S]
TYPOGRAPHY	the art of printing or using type [n TYPOGRAPHIES]
TYRANT	to play the oppressor, also TYRAN, TYRANNE [v -ED, -ING, -S]
UNACCOMPANIED	not accompanied [adj]
UNANNOUNCED	not announced [adj]
UNATTACHED	not assigned or committed (as to a particular task, organization, or person) [adj]
UNATTRACTIVE	not attractive [adj UNATTRACTIVELY]
UNAVOIDABLE	that cannot be avoided [adj UNAVOIDABLY]
UNBEATEN	not beaten [adj]
UNBRIDLED	UNBRIDLE, to set loose [v]
UNCONSCIOUS	not conscious, also INCONSCIOUS [adj UNCONSCIOUSLY] / the part of mental life that does not ordinarily enter the individual's awareness yet may influence behavior and perception or be revealed (as in slips of the tongue or in dreams) [n -ES]
UNDENIABLE	that cannot be denied [adj UNDENIABLY]
UNDERTAKE	to attempt [v UNDERTOOK, UNDERTAKEN, UNDERTAKING, UNDERTAKES]
UNDISPUTED	not disputed [adj UNDISPUTEDLY]
UNFORTUNATELY	UNFORTUNATE, not fortunate [adv]
UNIQUE	having no other of its kind [adj UNIQUER, UNIQUEST, UNIQUELY] / anything that is unique [n -S]
UNISON	complete agreement [n -S]
UNITE	to join together [v UNITED, UNITING, UNITES]
UNIVERSITY	an institution of higher learning providing facilities for teaching and research and authorized to grant academic degrees [n UNIVERSITIES]
UNLIMITED	not limited [adj UNLIMITEDLY]
UNNATURAL	not natural [adj UNNATURALLY]
UNNECESSARY	not necessary [adj UNNECESSARILY]
UNOFFICIAL	not official [adj UNOFFICIALLY]
UNPLEASANT	not pleasant [adj UNPLEASANTLY]
UNPOPULAR	not popular [adj UNPOPULARLY]
UNQUALIFIED	UNQUALIFY, to disqualify; to unfit [v]
UPHOLSTERER	one who upholsters [n -S]
URBAN	pertaining to a city [adj]
URGENCY	a strong urgency or drive [n URGENCIES]
USEFULLY	USEFUL, serving a purpose [adv]
VACANCIES	VACANCY, the state of being vacant, also VACANCE [n]
VALUABLE	having value [adj VALUABLY] / a possession of value [n -S]
VANQUISH	to defeat in battle [v -ED, -ING, -ES]
VARIETY	diversity [n VARIETIES]
VEGETABLE	a plant or part of one used for food, other than those considered to be fruits [n -S] / of the nature of a vegetable [adj VEGETABLY]
VEHICLE	a device used as a means of conveyance [n -S]
VENTILATION	the act of ventilating [n -S]
VERDANT	green with vegetation [adj VERDANTLY]
VERDICT	the decision of a jury at the end of a legal proceeding [n -S]
VERSATILE	turning easily from one thing to another [adj VERSATILELY]
VIBRANT	vibrating, resonant [adj VIBRANTLY] / a sonant, a voiced sound [n -S]
VICIOUS	dangerously aggressive [adj VICIOUSLY]
VIGILANCE	the state of being vigilant [n -S]
VIGILANT	watchful [adj VIGILANTLY]
VIGOROUS	full of vigor [adj VIGOROUSLY]
VILLAGES	VILLAGE, a small community in a rural area [n]
VINDICATE	to justify, to clear of criticism [v VINDICATED, VINDICATING, VINDICATES]
VINEGAR	to treat with a sour liquid used as a condiment or preservative [v -ED, -ING, -S]
VIOLET	any plant or flower of the genus Viola [n -S]
VISIBLY	VISIBLE, able to be seen [adv]
VOCABULARY	a list or collection of words or of words and phrases usually alphabetically arranged and explained or defined [n VOCABULARIES]
VOLATILE	readily vaporizable at a relatively low temperature [adj] / a winged creature [n -S]
VOYAGE	to travel [v VOYAGED, VOYAGING, VOYAGES]
VULTURES	VULTURE, a bird of prey [n]
WAITER	one who serves at table [n -S] / to serve at table [v -ED, -ING, -S]
WANT	to have a desire for [v -ED, -ING, -S]
WASH	to cleanse in liquid [v WASHED, (obsolete) WASHEN, WASHING, WASHES]
WATCH	to keep in view [v -ED, -ING, -ES]
WEARY	tired [adj WEARIER, WEARIEST, WEARILY] / to make tired [v WEARIED, WEARYING, WEARIES]
WEIGH	to determine the weight of [v -ED, -ING, -S]
WEIGHED	WEIGH, to determine the weight of [v]
WEIGHT	to add heaviness to [v -ED, -ING, -S]
WEIRD	eerily strange, also WEYARD, WEYWARD [adj WEIRDER, WEIRDEST, WEIRDLY] / (Scots) to destine, to doom [v -ED, -ING, -S]
WHALE	any of an order of cetaceous mammals [n -S] / to hunt whales [v WHALED, WHALING, WHALES]
WHERE	the place at or in which something is located or occurs, also WHAUR, WHEAR, WHEARE [n WHERES]
WHETHER	if it be the case that [conj]
WHICH	what particular one [pron]
WHILE	to pass time pleasantly [v WHILED, WHILING, WHILES]
WHITE	of the color of pure snow [adj WHITER, WHITEST, WHITELY] / to make white, whiten [v WHITED, WHITING, WHITES]
WHOLESOME	healthy, whole, also HEALSOME, HOLESOM, HOLESOME [adj WHOLESOMER, WHOLESOMEST, WHOLESOMELY]
WHOLLY	WHOLE, entire [adv]
WIDESPREAD	widely diffused or prevalent [adj]
WINNER	one that wins [n -S]
WISTFUL	yearning [adj WISTFULLY]
WOMEN	WOMAN, a female [n]
WONDROUS	strange, wonderful, also WONDEROUS [adj WONDROUSLY]
WORRIED	WORRY, to cause to be anxious [v]
WRAPPED	WRAP, to enclose [v]
WRAPPER	to put a covering on [v -ED, -ING, -S]
WRECK	to cause the ruin of, also WRACK [v -ED, -ING, -S]
WRESTLING	the sport of wrestling [n -S]
WRETCHED	miserable [adj WRETCHEDER, WRETCHEDEST, WRETCHEDLY]
WRINKLE	to crease [v WRINKLED, WRINKLING, WRINKLES]
WRIST	the junction between the hand and forearm [n -S] / in ice-hockey, to sweep the puck alongside the ice before shooting [v -ED, -ING, -S]
WRITE	to form characters on a surface with an instrument [v WROTE or (obsolete) WRATE or WRIT, WRITTEN, WRITING, WRITES]
WRITTEN	WRITE, to form characters on a surface with an instrument [v]
WRONG	not according to what is right, proper, or correct [adj WRONGER, WRONGEST, WRONGLY] / to treat injuriously or unjustly [v -ED, -ING, -S]
XENOPHOBIA	fear of foreigners, also XENOPHOBY [n -S]
YEAST	to ferment [v -ED, -ING, -S]
YIELD	to give up [v YIELDED or (obsolete) YOLD, YIELDING, YIELDS]
YOUNGSTER	a young person [n -S]
YOUTHFUL	young [adj YOUTHFULLY]
ZOOLOGY	the science of animals [n ZOOLOGIES]
