ABIDE	to wait for; to stay, dwell [v ABID or ABODE or ABIDED, ABIDDEN, ABIDING, ABIDES]
ABUNDANCE	the state of being abundant, also ABUNDANCY [n -S]
ACCELERATING	ACCELERATE, to bring about at an earlier time [v]
ACCEPTANCE	the act of accepting, also ACCEPTANCY [n -S]
ACCESS	approach, admittance [n -ES] / to have entrance to [v -ED, -ING, -ES]
ACCIDENTALLY	ACCIDENTAL, by accident [adv]
ACCIDENTS	ACCIDENT, a mishap [n]
ACCORDANCE	agreement, also ACCORDANCY [n -S]
ACHE	to endure a dull lasting pain, also AKE [v ACHED, ACHING, ACHES]
ACHIEVING	ACHIEVE, to carry out successfully [v]
ACQUIRE	to come into possession of [v ACQUIRED, ACQUIRING, ACQUIRES]
ACTOR	a theatrical performer [n -S]
ACTUALLY	ACTUAL, existing in fact [adv]
ADDITION	something added [n -S]
ADMIRABLE	worthy of being admired [adj ADMIRABLY]
ADVANCE	to put forward, to go forward [v ADVANCED, ADVANCING, ADVANCES]
ADVERTISEMENT	the act of advertising [n -S]
AFFAIR	something which is to be done [n -S]
AFFECT	to act upon [v -ED, -ING, -S]
AGILITY	nimbleness [n AGILITIES]
AGREEABLE	pleasant [adj]
ALIAS	(Latin) an assumed name [n -ES] / to assume an alternative name [v ALIASED, ALIASING, ALIASED]
AMUSEMENTS	AMUSEMENT, a recreation, pastime [n]
ANAGRAM	a word or phrase formed by the letters of another in different order [n -S] / to transpose letters to form new words [v ANAGRAMMED, ANAGRAMMING, ANAGRAMS]
ANCESTOR	someone from whom a person is descended, a forefather [n -S] / to be an ancestor to [v -ED, -ING, -S]
ANCIENT	very old, also ANTIENT [adj ANCIENTER, ANCIENTEST, ANCIENTLY] / an old person [n -S]
ANGEL	to support financially [v -ED, -ING, -S]
ANNIVERSARY	the annual recurrence of a date marking a notable event [n ANNIVERSARIES]
ANNOYANCE	something that annoys [n -S]
ANNUITY	income paid at regular intervals [n ANNUITIES]
ANXIOUS	full of fear [adj ANXIOUSLY]
ANXIOUSLY	ANXIOUS, full of fear [adv]
APPEAL	to make an earnest request [v -ED, -ING, -S]
APPOINT	to assign to a job [v -ED, -ING, -S]
APPOINTMENT	an act of appointing [n -S]
APPRECIATED	APPRECIATE, to grasp the nature, worth, quality, or significance of [v]
APPRENTICE	to set someone to work to learn a trade [v APPRENTICED, APPRENTICING, APPRENTICES]
APPROACH	to come near to [v -ED, -ING, -ES]
ARCHITECT	a designer of buildings [n -S] / to construct [v -ED, -ING, -S]
ARMOUR	to dress with defensive covering, also ARMOR [v -ED, -ING, -S]
ATHLETE	a competitor in contests of strength and speed, also ATHLETA [n -S]
ATHLETIC	relating to vigorous physical exercise [adj ATHLETICALLY]
ATMOSPHERE	the body of air and gas which surrounds the earth [n -S]
ATOMIC	of or pertaining to atoms, also ATOMICAL [adj ATOMICALLY]
ATTEMPT	to endeavour [v -ED, -ING, -S]
ATTITUDE	a posture or position [n -S]
ATTRACTIVE	having or relating to the power to attract [adj ATTRACTIVELY]
AUDIBLE	able to be heard [adj AUDIBLY] / a tactic or game plan shouted out in coded form by a quarterback in American football [n -S] / to call out such a plan [v AUDIBLED, AUDIBLING, AUDIBLES]
AUTONOMOUS	of, relating to, or marked by autonomy [adj AUTONOMOUSLY]
AVAIL	to be of use or advantage to [v -ED, -ING, -S]
AVOCADO	(Nahuatl) a rough-skinned pear-shaped edible fruit of a tropical tree [n AVOCADOS or AVOCADOES]
AVOID	to evade [v -ED, -ING, -S]
BADGER	to pester or harass [v -ED, -ING, -S]
BAGGAGE	luggage [n -S]
BANKRUPTCY	the state of being bankrupt [n BANKRUPTCIES]
BAULK	to refrain from proceeding, also BALK, BAUK [v -ED, -ING, -S]
BEAUTIFUL	fair to look at [adj BEAUTIFULLER, BEAUTIFULLEST, BEAUTIFULLY]
BEGINNING	the start of something [n -S]
BELIEVING	accepting as true or real [adj BELIEVINGLY] / the act of believing [n -S]
BENEFIT	to obtain an advantage [v BENEFITED or BENEFITTED, BENEFITING or BENEFITTING, BENEFITS]
BENT	a stiff wiry grass, also BENTGRASS [n -S]
BERET	a flat round woollen cap, also BERRET [n -S]
BESOTTED	BESOT, to infatuate [v]
BETROTHED	one who is engaged to be married [n -S]
BIOLOGY	the science of life [n BIOLOGIES]
BISQUE	(French) a rich shellfish soup, made with wine and cream, also BISK [n -S]
BOMB	to attack with an exploding device [v -ED, -ING, -S]
BOTANY	the science of plants [n BOTANIES]
BOUNCING	BOUNCE, to spring back [v]
BOUNDARY	a final limit [n BOUNDARIES]
BRAISE	to cook slowly with a little liquid in a tightly closed vessel [v BRAISED, BRAISING, BRAISES]
BREATH	air inhaled and exhaled [n -S]
BREATHLESS	not breathing [adj BREATHLESSLY]
BREECHES	BREECH, to clothe with breeches [v]
BREVITY	shortness of duration [n BREVITIES]
BRILLIANCE	the state of being brilliant, also BRILLIANCY [n -S]
BRUTALLY	BRUTAL, cruel, savage [adj]
BUDGET	to estimate expenses [v -ED, -ING, -S]
BUOY	to mark with a warning float [v -ED, -ING, -S]
BUSIER	BUSY, occupied [adj]
BYPASS	to avoid by going around [v -ED, -ING, -ES]
CAFFEINE	a bitter alkaloid used as a stimulant, also CAFFEIN [n -S]
CAJOLE	to persuade by flattery [v CAJOLED, CAJOLING, CAJOLES]
CALCULATOR	one that calculates [n -S]
CAPACITY	the ability to receive or contain [n CAPACITIES]
CAPTURE	to take by force or cunning [v CAPTURED, CAPTURING, CAPTURES]
CARCASSES	CARCASS, to put a framework on, also CARCASE [v]
CARPENTRY	the craft of working with wood [n CARPENTRIES]
CARRIAGE	a wheeled horse-drawn vehicle [n -S]
CARRIED	CARRY, to convey from one place to another [v]
CARRIES	CARRY, to convey from one place to another [v]
CARRYING	CARRY, to convey from one place to another [v]
CATCH	to capture after pursuit [v CATCHT or CAUGHT or CATCHED, CATCHING, CATCHES]
CATEGORY	a division in any system of classification [n CATEGORIES]
CAUGHT	CATCH, to capture after pursuit [v]
CEASE	to stop [v CEASED, CEASING, CEASES]
CELEBRATION	the act of celebrating [n -S]
CELL	to store in a honeycomb [v -ED, -ING, -S]
CELLAR	to store in an underground room [v -ED, -ING, -S]
CEMETERY	a burial ground [n CEMETERIES]
CENSORSHIP	the institution, system, or practice of censoring [n -S]
CERTIFIED	CERTIFY, to declare as true [v]
CHALLENGE	an invitation to a contest [n -S] / to summon (someone) to settle a matter by fighting or by any kind of contest [v CHALLENGED, CHALLENGING, CHALLENGES]
CHAMBER	to put in a room [v -ED, -ING, -S]
CHAMPIONSHIP	the position of honour gained by being champion [n -S]
CHAMPIONSHIPS	CHAMPIONSHIP, the position of honour gained by being champion [n]
CHANCE	to risk [v CHANCED, CHANCING, CHANCES]
CHANGEABLE	given to change [adj CHANGEABLY]
CHARIOT	to ride in a two-wheeled, horse-drawn vehicle [v -ED, -ING, -S]
CHATTED	CHAT, to talk informally [v]
CHEMISTRY	the physical science of the properties of elementary and compound substances, also CHYMISTRY [n CHEMISTRIES]
CHEQUES	CHEQUE, a written order directing a bank to pay money [n]
CHILLIEST	CHILLY, cool [adj]
CHOIR	to sing in chorus [v -ED, -ING, -S]
CHOPPED	CHOP, to sever with a sharp tool [v]
CHROME	to plate with chromium [v CHROMED, CHROMING, CHROMES]
CHRYSALIS	a pupa, esp. of a moth or butterfly, enclosed in a firm case or cocoon, also CHRYSALID [n CHRYSALISES or CHRYSALIDES]
CINEMA	a motion-picture theatre, also KINEMA [n -S]
CIRCUMSPECT	careful to consider all circumstances and possible consequences [adj CIRCUMSPECTLY]
CLAPPING	the act of clapping [n -S]
CLAUSTROPHOBIA	fear of closed spaces [n -S]
CLIMATIC	pertaining to climate [adj CLIMATICALLY]
CLIMB	to ascend [v CLAMBE or CLOMB or CLIMBED, CLIMBING, CLIMBS]
CLOCKWISE	moving in the direction of a clock's hands [adv]
CLUMSILY	CLUMSY, not dexterous [adv]
CLUTCH	to grasp and hold tightly [v -ED, -ING, -ES]
COCKATIEL	(Dutch) a small crested parrot of Australia, also COCKATEEL [n -S]
COINCIDE	to be identical [v COINCIDED, COINCIDING, COINCIDES]
COLLOQUIAL	of or relating to conversation [adj COLLOQUIALLY] / a conversation [n -S]
COLOSSAL	of enormous size [adj COLOSSALLY]
COLOUR	to paint, also COLOR [v -ED, -ING, -S]
COLOURLESS	without colour, also COLORLESS [adj COLOURLESSLY]
COLUMN	a vertical cylindrical support [n -S]
COMICAL	amusing, also COMIC [adj COMICALLY]
COMMENTARY	an explanatory treatise [n COMMENTARIES]
COMMERCIAL	related to commerce [adj COMMERCIALLY] / an advertisement broadcast on radio or television [n -S]
COMMIT	to perpetrate [v COMMITTED, COMMITTING, COMMITS]
COMMUNITY	a body of people in the same locality [n COMMUNITIES]
COMPEL	to force [v COMPELLED, COMPELLING, COMPELS]
COMPETENCE	the quality of being competent, also COMPETENCY [n -S]
COMPETITION	the act of competing [n -S]
COMPLAINED	COMPLAIN, to express discontent [v]
COMPLETE	to bring to an end [v COMPLETED, COMPLETING, COMPLETES] / having all necessary parts [adj COMPLETER, COMPLETEST, COMPLETELY]
COMPOSING	COMPOSE, to settle or soothe [v]
CONCEIT	to form a conception of [v -ED, -ING, -S]
CONCENTRATING	CONCENTRATE, to bring or direct toward a common center or objective [v]
CONCENTRATION	the act of concentrating [n -S]
CONCEPT	a general idea [n -S]
CONDITION	to treat hair with conditioner [v -ED, -ING, -S]
CONDUCT	to lead or guide [v -ED, -ING, -S]
CONDUCTOR	a person or thing that conducts [n -S]
CONDUIT	a channel or pipe for conveying fluids [n -S]
CONFIDENT	self-assured [adj CONFIDENTLY] / a person in whom another confides, also CONFIDANT [n -S]
CONFIGURATION	external figure, shape or arrangement [n -S]
CONFUSION	the state of being confused [n -S]
CONGENIAL	pleasant, friendly or agreeable [adj CONGENIALLY]
CONSEQUENTLY	CONSEQUENT, following [adv]
CONSERVATION	a careful preservation and protection of something [n -S]
CONSTITUTE	to form [v CONSTITUTED, CONSTITUTING, CONSTITUTES]
CONTEMPLATIVE	related to contemplation [adj CONTEMPLATIVELY] / a person who practices contemplation [n -S]
CONTINUED	CONTINUE, to go on with [v]
CONTINUITY	a script or scenario in the performing arts [n CONTINUITIES]
CONTRADICTORY	serving to contradict [adj CONTRADICTORILY] / a word or principle that contradicts another [n CONTRADICTORIES]
CONTRAPTIONS	CONTRAPTION, a device, a gadget [n]
COPIOUS	abundant [adj COPIOUSLY]
CORONATION	the act or occasion of crowning [n -S]
COUNTIES	COUNTY, an administrative division of a state [n]
COUPON	a voucher [n -S]
COURT	to woo [v -ED, -ING, -S]
COUSCOUS	the grain of the African millet, also COUSCOUSOU, CUSCUS, KHUSKHUS, KOUSKOUS [n -ES]
CRAZIER	CRAZY, insane [adj]
CREATION	something that is created [n -S]
CREATURE	a living being [n -S]
CRIED	CRY, to utter a sound of distress or to weep [v]
CRIES	CRY, to utter a sound of distress or to weep [v]
CRIMINAL	relating to crime [adj CRIMINALLY] / one who has committed a crime [n -S]
CRITICALLY	CRITICAL, given to criticism [adv]
CRITICISM	the act of criticising [n -S]
CUDDLY	pleasant to cuddle [adj CUDDLIER, CUDDLIEST]
CURB	to restrain [v -ED, -ING, -S]
CURTAIN	to furnish with hanging fabric [v -ED, -ING, -S]
CYCLING	the act of riding a bicycle [n -S]
CYNICAL	distrusting [adj CYNICALLY]
DAMAGED	DAMAGE, to damage [v]
DAMAGING	DAMAGE, to damage [v]
DANGEROUS	full of danger [adj DANGEROUSLY]
DEAD	not alive [adj DEADER, DEADEST] / (obsolete) to lose vitality, become numb [v -ED, -ING, -S]
DEAF	lacking the sense of hearing [adj DEAFER, DEAFEST, DEAFLY]
DEBRIS	scattered remains [n DEBRIS]
DECIDE	to make a choice [v DECIDED, DECIDING, DECIDES]
DECISION	the act of deciding [n -S] / to win a boxing decision [v -ED, -ING, -S]
DECORATE	to adorn [v DECORATED, DECORATING, DECORATES]
DEFIANT	showing defiance [adj DEFIANTLY]
DEFICIT	an inadequacy or insufficiency [n -S]
DEFINITE	known for certain [adj DEFINITELY] / something that is known for certain [n -S]
DEFINITELY	DEFINITE, known for certain [adv]
DELICIOUS	tasting very good [adj DELICIOUSLY]
DELINQUENT	failing in duty; of or concerning a bad debt or debtor [adj DELINQUENTLY] / an offender, esp. a young criminal [n -S]
DEMOLISHED	DEMOLISH, to destroy [v]
DENIED	DENY, to declare to be untrue, also DENAY [v]
DEPRIVED	DEPRIVE, to take something away from [v]
DESIGN	to plan in outline, also DESINE, DESYNE [v -ED, -ING, -S]
DESPERATION	loss of hope and surrender to despair [n -S]
DEVOID	completely lacking [adj]
DEVOTION	the act of devoting [n -S]
DIAMOND	to adorn with precious gems [v -ED, -ING, -S]
DIARIES	DIARY, a personal journal [n]
DIARY	a personal journal [n DIARIES]
DICTATOR	one that dictates [n -S]
DICTIONARY	a book containing the words of a language alphabetically arranged, with their meanings, etymology, etc. [n DICTIONARIES]
DIGESTED	DIGEST, to assimilate food in the stomach, also DISGEST [v]
DIRECTIONS	DIRECTION, aim at a certain point [n]
DISADVANTAGE	to place at a disadvantage [v DISADVANTAGED, DISADVANTAGING, DISADVANTAGES]
DISBELIEVE	to hold not worthy of belief [v DISBELIEVED, DISBELIEVING, DISBELIEVES]
DISEMBARK	to leave a ship, to land [v -ED, -ING, -S]
DISHEARTEN	to cause to lose spirit or morale [v -ED, -ING, -S]
DISINFECTANT	an agent that frees from infection [n -S]
DISINTERESTED	having no personal stake [adj DISINTERESTEDLY]
DISPOSABLE	able to be disposed of [adj] / something that is disposable [n -S]
DISQUALIFY	to debar [v DISQUALIFIED, DISQUALIFYING, DISQUALIFIES]
DISSATISFIED	DISSATISFY, to fail to satisfy [v]
DISSATISFY	to fail to satisfy [v DISSATISFIED, DISSATISFYING, DISSATISFIES]
DISTANT	far off or apart [adj DISTANTLY]
DOLLOP	to dispense in small amounts [v -ED, -ING, -S]
DRAUGHT	to draft [v -ED, -ING, -S]
DRIVING	of rain, heavy and windblown [adj DRIVINGLY] / the act of driving [n -S]
DROPPING	something that has been dropped [n -S]
DROUGHT	a dry period [n -S]
DUGONG	(Malay) an aquatic mammal, aka manatee or sea-cow [n -S]
DUSTIER	DUSTY, full of dust [adj]
DWELL	to reside [v DWELT or DWELLED, DWELLING, DWELLS]
DYE	to change the colour of [v DYED, DYEING, DYES]
EAGER	a tidal flood, also EAGRE, EGER [n -S] / full of keen desire, also AYGRE [adj EAGERER, EAGEREST, EAGERLY]
EARN	to gain or deserve for one's labour or service, also ERN [v EARNED or EARNT, EARNING, EARNS]
EARNEST	serious [adj EARNESTLY] / a pledge of good intent [n -S]
EASIEST	EASY, not difficult [adj]
EASILY	EASY, not difficult [adv]
ECHO	a reflected sound [n ECHOES or ECHOS] / to repeat a sound [v -ED, -ING, -ES]
EDIFICE	a building [n -S]
EFFECTIVE	that works [adj EFFECTIVELY] / an effective serviceman or other person [n -S]
EGOTISM	self-conceit [n -S]
ELECTORATE	the territory, jurisdiction, or dignity of a German elector [n -S]
ELITE	a socially select group [n -S]
ELVES	ELF, a fairylike being [n]
EMANCIPATE	to free from restraint, control, or the power of another [v EMANCIPATED, EMANCIPATING, EMANCIPATES]
EMBARRASSED	EMBARRASS, to discomfit [v]
EMBLEM	to represent with a symbolic device [v -ED, -ING, -S]
EMBOSS	to decorate with a raised design, also IMBOSS [v EMBOSSED, EMBOST, EMBOSSING, EMBOSSES]
EMPHASIS	stress imparted to something to indicate significance [n EMPHASES]
EMPLOYABLE	that can be employed [adj] / one who is employable [n -S]
EMPTINESS	the state of being empty [n -ES]
ENCAPSULATE	to enclose in or as if in a capsule, also INCAPSULATE [v ENCAPSULATED, ENCAPSULATING, ENCAPSULATES]
ENDANGERED	ENDANGER, to expose to loss or injury [v]
ENEMIES	ENEMY, one that is antagonistic toward another [n]
ENGINEER	to arrange or contrive [v -ED, -ING, -S]
ENJOY	to take pleasure in [v -ED, -ING, -S]
ENJOYMENT	the act of enjoying [n -S]
ENTERTAINED	ENTERTAIN, to hold the attention or thoughts of; to amuse [v]
EPIDEMIC	occurring in many places [adj EPIDEMICALLY] / a rapid spread of a disease [n -S]
EQUILATERAL	having all sides equal [adj EQUILATERALLY] / a shape with all sides equal [n -S]
ESCAPING	ESCAPE, to free oneself [v]
ESTUARY	the tidal mouth of a large river [n ESTUARIES]
EVALUATION	the act of evaluating [n -S]
EXAGGERATE	to enlarge beyond bounds or the truth [v EXAGGERATED, EXAGGERATING, EXAGGERATES]
EXAM	an examination [n -S]
EXAMINE	to inspect [v EXAMINED, EXAMINING, EXAMINES]
EXAMPLE	to illustrate, show by representation [v EXAMPLED, EXAMPLING, EXAMPLES]
EXCELLING	EXCEL, to surpass others [v]
EXCITING	EXCITE, to arouse the emotions of [v]
EXCLAIMING	EXCLAIM, to cry out in surprise [v]
EXCLUSION	the act of excluding [n -S]
EXEMPLIFY	to serve as an example [v EXEMPLIFIED, EXEMPLIFYING, EXEMPLIFIES]
EXERT	to make an effort [v -ED, -ING, -S]
EXHIBITIONS	EXHIBITION, an act or instance of exhibiting [n]
EXHUME	to dig out from the earth, also EXHUMATE [v EXHUMED, EXHUMING, EXHUMES]
EXONERATE	to clear of blame [v EXONERATED, EXONERATING, EXONERATES]
EXPEL	to force out [v EXPELLED, EXPELLING, EXPELS]
EXPENSIVE	costing a lot of money [adj EXPENSIVELY]
EXPERIENCE	to have practical acquaintance with [v EXPERIENCED, EXPERIENCING, EXPERIENCES]
EXPIRE	to come to an end [v EXPIRED, EXPIRING, EXPIRES]
EXPLAINING	EXPLAIN, to make clear and understandable [v]
EXPLODED	EXPLODE, to blow up [v]
EXPLODING	EXPLODE, to blow up [v]
EXPLORE	to examine thoroughly [v EXPLORED, EXPLORING, EXPLORES]
EXPRESSION	an act, process, or instance of representing in a medium [n -S]
EXQUISITE	delicate and intricate [adj EXQUISITELY] / a person who is obsessively or fashionably exact or fastidious in dress [n -S]
EXTERIOR	outside [adj EXTERIORLY] / a part or surface that is outside [n -S]
EXTERNAL	on the outside [adj EXTERNALLY] / an exterior [n -S]
EXTREMELY	EXTREME, farthest from centre [adv]
EXTROVERT	turning outwards, also EXTRAVERT [adj EXTROVERTLY] / to turn outwards [v -ED, -ING, -S]
EXUBERANT	luxuriant, overflowing [adj EXUBERANTLY]
FABULOUS	amazing, excellent [adj FABULOUSLY]
FACE	to confront [v FACED, FACING, FACES]
FACILITIES	FACILITY, ease in performance or action [n]
FACILITY	ease in performance or action [n FACILITIES]
FAMILIAR	well-known [adj FAMILIARLY] / a close friend or associate [n -S]
FASHIONABLE	according to fashion [adj FASHIONABLY] / a fashionable person [n -S]
FAULT	to criticize [v -ED, -ING, -S]
FAVOR	to regard with goodwill, also FAVOUR [v -ED, -ING, -S]
FEATHER	to cover with the plumage of birds [v -ED, -ING, -S]
FEATURES	FEATURE, to present prominently [v]
FELLOWSHIP	the state of being a fellow or partner [n -S] / to join in fellowship esp. with a church member [v FELLOWSHIPED or FELLOWSHIPPED, FELLOWSHIPING or FELLOWSHIPPING, FELLOWSHIPS]
FIBROUS	containing, or consisting of, fibers [adj FIBROUSLY]
FIELD	to play as a fielder [v -ED, -ING, -S]
FINANCE	to supply the money for [v FINANCED, FINANCING, FINANCES]
FINANCIAL	relating to finance [adj FINANCIALLY]
FINANCIER	a person engaged in large financial transactions [n -S] / to conduct financial operations; to swindle [v -ED, -ING, -S]
FINICKY	difficult to please, also FINNICKY [adj FINICKIER, FINICKIEST]
FLAVOUR	to impart a special taste to, also FLAVOR [v -ED, -ING, -S]
FLUENT	flowing [adj FLUENTLY] / the variable quantity in fluxions [n -S]
FORMATION	something formed or made [n -S]
FORTY	a number [n FORTIES]
FRACTION	to divide into portions [v -ED, -ING, -S]
FRAGRANT	having a pleasant perfume [adj FRAGRANTLY]
FRAUGHT	to load with tension [v -ED, -ING, -S] / laden with tension [adj FRAUGHTER, FRAUGHTEST]
FRIED	FRY, to cook in fat or oil [v]
FRIENDS	FRIEND, to enter into a warm association with [v]
FRIVOLOUS	lacking seriousness [adj FRIVOLOUSLY]
FUCHSIA	a flowering shrub [n -S]
FUNNIER	FUNNY, amusing [adj]
FURTHER	to help forward [v -ED, -ING, -S]
FUTILE	ineffective [adj FUTILER, FUTILEST, FUTILELY]
GENERATE	to bring into existence [v GENERATED, GENERATING, GENERATES]
GENERIC	general; applicable to any of a group or class, also GENERICAL [adj GENERICALLY] / a generic drug [n -S]
GENEROUS	willing to give [adj GENEROUSLY]
GENTLY	GENTLE, mild and refined in manners [adv]
GENUINE	authentic [adj]
GEOGRAPHY	the study of the earth's physical and human features [n GEOGRAPHIES]
GETTING	begetting, procreation [n -S]
GIGANTIC	huge, also GIGANTEAN [adj GIGANTICALLY]
GLAMOUR	to bewitch, also GLAMOR [v -ED, -ING, -S]
GLOBAL	worldwide or comprehensive [adj GLOBALLY]
GLOBALISM	internationalism [n -S]
GNARLED	GNARL, to twist into a state of deformity, also KNARL [v]
GNASH	to grind the teeth together [v -ED, -ING, -ES]
GNAWED	GNAW, to wear away by persistent biting [v]
GNOMES	GNOME, a fabled little person [n]
GOALKEEPER	a player who defends the goal in any of various games (as hockey, lacrosse, or soccer) [n -S]
GOANNA	a large monitor lizard [n -S]
GOBLET	a drinking vessel [n -S]
GOODNIGHT	a common salutation on parting at night [n -S]
GRANDFATHER	the father of one's mother or father [n -S] / to exempt (an activity, person, etc.) from a new piece of legislation, restriction or the like [v -ED, -ING, -S]
GRAPH	to represent by a diagram [v -ED, -ING, -S]
GRAPHICS	GRAPHIC, a painting or drawing [n]
GRATEFULLY	GRATEFUL, deeply thankful [adv]
GREGARIOUS	tending to associate with others of one's kind [adj GREGARIOUSLY]
GRUMBLY	muttering in discontent [adj GRUMBLIER, GRUMBLIEST]
GUARANTEE	to give a formal promise that something will be done [v GUARANTEED, GUARANTEEING, GUARANTEES]
GUIDANCE	advice [n -S]
GYNAECOLOGY	the study of women's physiology, also GYNECOLOGY [n GYNAECOLOGIES]
GYPSY	to live like a gypsy (a wanderer), also GIPSY [v GYPSIED, GYPSYING, GYPSIES]
HAEMOGLOBIN	the iron-containing pigment which is the oxygen-carrying substance present in the red blood cells of vertebrates, also HEMOGLOBIN [n -S]
HALLUCINATE	to affect with visions or imaginary perceptions [v HALLUCINATED, HALLUCINATING, HALLUCINATES]
HAPPIER	HAPPY, marked by joy [adj]
HARRY	to plunder, ravage [v HARRIED, HARRYING, HARRIES]
HAUNT	to visit frequently [v -ED, -ING, -S]
HEAVIER	HEAVY, of great weight [adj]
HEAVINESS	the state of being heavy [n -ES]
HEIGHT	the highest point, also HEIGHTH, HIGHTH [n -S]
HEIR	a person who actually succeeds to property, title, etc. on the death of its previous holder [n -S] / to inherit [v -ED, -ING, -S]
HELICOPTER	a flying machine sustained by rotating blades revolving on a vertical axis above the machine [n -S] / to travel by helicopter [v -ED, -ING, -S]
HEROIC	brave, also HEROICAL [adj HEROICLY or HEROICALLY] / an epic verse [n -S]
HESITANCE	wavering, doubt, also HESITANCY [n -S]
HESITATE	to hold back or delay [v HESITATED, HESITATING, HESITATES]
HIBISCUS	(Latin) any of numerous chiefly tropical herbaceous plants, shrubs, and trees of the genus Hibiscus [n -ES]
HIDEOUS	very ugly [adj HIDEOUSLY]
HOLIDAY	to take a vacation [v -ED, -ING, -S]
HOMICIDE	the killing of one person by another [n -S]
HONOR	to treat with respect, also HONOUR [v -ED, -ING, -S]
HOPPER	a container for grain, also HOPPERCAR [n -S]
HORRIBLE	dreadful [adj HORRIBLY] / something horrible [n -S]
HORRIFIC	causing horror [adj HORRIFICALLY]
HORRIFIED	HORRIFY, to cause a reaction of horror [v]
HOSTEL	to stay overnight in hostels when travelling [v HOSTELED or HOSTELLED, HOSTELING or HOSTELLING, HOSTELS]
HUGGED	HUG, to clasp tightly in the arms [v]
HUGGING	HUG, to clasp tightly in the arms [v]
HUMOUR	to indulge, also HUMOR [v -ED, -ING, -S]
HUNGRILY	HUNGRY, having a craving desire [adv]
HURRIEDLY	HURRIED, HURRY, to move swiftly [adv]
HURRIES	HURRY, to move swiftly [v]
HURRYING	the act of hurrying [n -S]
HYPOCRITE	one who pretends to be better or other than they are [n -S]
IDENTIFICATION	an act of identifying [n -S]
IDYLLIC	of or like an idyll [adj IDYLLICALLY]
IGNORANT	not knowing things [adj IGNORANTLY] / an ignorant person [n -S]
ILLITERATE	having little or no education [adj ILLITERATELY] / one with little or no education [n -S]
IMMOBILE	stationary [adj]
IMMORAL	promiscuous or unscrupulous [adj IMMORALLY]
IMMORTALS	IMMORTAL, one who is not subject to death [n]
IMPATIENCE	the state of being impatient [n -S]
IMPATIENT	not patient [adj IMPATIENTLY]
IMPEACH	to accuse of impropriety, also EMPEACH [v -ED, -ING, -ES]
IMPERIAL	commanding [adj IMPERIALLY] / an emperor or member of an imperial family [n -S]
IMPERMANENT	not permanent [adj IMPERMANENTLY]
IMPERTURBABLE	marked by extreme calm, impassivity, and steadiness [adj IMPERTURBABLY]
IMPLICATE	to involve, to entangle [v IMPLICATED, IMPLICATING, IMPLICATES]
IMPOLITE	having bad manners [adj IMPOLITER, IMPOLITEST, IMPOLITELY]
IMPRECISE	not precise, also UNPRECISE [adj IMPRECISELY]
IMPRESSION	a stamp, form, or figure resulting from physical contact [n -S]
IMPROBABLE	not probable [adj IMPROBABLY]
IMPROPER	not proper [adj IMPROPERER, IMPROPEREST; IMPROPERLY]
IMPROVEMENT	the act of improving [n -S]
INACCURACIES	INACCURACY, the state of being inaccurate [n]
INARTICULATE	not articulate, also UNARTICULATE [adj INARTICULATELY] / any of a class of brachiopods lacking a hinge connecting the two shell valves [n -S]
INATTENTIVE	not attentive [adj INATTENTIVELY]
INAUDIBLE	that cannot be heard [adj INAUDIBLY]
INCIDENTALLY	INCIDENTAL, by the way [adv]
INCLINED	INCLINE, to slant [v]
INCLUDING	INCLUDE, to take in as part of a whole [v]
INCOMPLETE	lacking a part [adj INCOMPLETELY]
INCONSEQUENTIAL	of no consequence [adj]
INCONSIDERATELY	INCONSIDERATE, heedless, thoughtless [adv]
INCORPORATE	to form into a body [v INCORPORATED, INCORPORATING, INCORPORATES]
INCORRECT	not correct [adj INCORRECTLY]
INCORRECTLY	INCORRECT, not correct [adv]
INDECENTLY	INDECENT, not decent, also UNDECENT [adv]
INEDIBLE	not fit to be eaten, also UNEDIBLE [adj INEDIBLY]
INEFFICIENT	not efficient [adj INEFFICIENTLY] / one who is not efficient [n -S]
INERTIA	(Latin) the tendency of a body to resist acceleration [n INERTIAS or INERTIAE]
INEXCUSABLE	that cannot be excused [adj INEXCUSABLY]
INEXPENSIVE	not expensive, also UNEXPENSIVE [adj INEXPENSIVELY]
INFLUENCE	to have or exert an effect on [v INFLUENCED, INFLUENCING, INFLUENCES]
INFORMATION	the communication or reception of knowledge or intelligence [n -S]
INITIAL	at the beginning [adj INITIALLY] / to mark with the first letters of one's name [v INITIALED or INITIALLED, INITIALING or INITIALLING, INITIALS]
INQUIRED	INQUIRE, to ask about, also ENQUIRE [v]
INSIGNIFICANTLY	INSIGNIFICANT, not significant [adv]
INSINCERELY	INSINCERE, not sincere [adv]
INSOLENT	impertinent [adj INSOLENTLY] / an insolent person [n -S]
INSPECTOR	one who inspects; a police rank [n -S]
INSTANT	without delay [adj INSTANTER, INSTANTLY] / a very short period of time [n -S]
INSTANTANEOUS	done, occurring, or acting without any perceptible duration of time [adj INSTANTANEOUSLY]
INTEND	to have as one's aim or purpose [v -ED, -ING, -S]
INTERESTING	INTEREST, to engage the attention of [v]
INTIMATE	innermost [adj INTIMATELY] / to make known indirectly [v INTIMATED, INTIMATING, INTIMATES]
INTREPID	fearless [adj INTREPIDLY]
INTRIGUE	to arouse the curiosity of [v INTRIGUED, INTRIGUING, INTRIGUES]
INVENTOR	one who invents, also INVENTER [n -S]
INVESTIGATING	INVESTIGATE, to observe or study by close examination and systematic inquiry [v]
INVESTIGATION	the act of investigating [n -S]
INVESTIGATIONS	INVESTIGATION, the act of investigating [n]
INVINCIBLE	unconquerable [adj INVINCIBLY]
INVITATION	the act of inviting [n -S]
INVITE	to request the presence of [v INVITED, INVITING, INVITES]
IRRESISTIBLE	impossible to resist [adj IRRESISTIBLY]
IRRESPONSIBLE	not responsible [adj IRRESPONSIBLY] / a person who is irresponsible [n -S]
ISSUE	to put into circulation [v ISSUED, ISSUING, ISSUES]
ITEMS	ITEM, to set down the particulars of, also ITEMISE, ITEMIZE [v]
JEALOUS	resentful of another's advantages, also GEALOUS [adj JEALOUSER, JEALOUSEST; JEALOUSLY]
JEOPARDY	a hazard or danger [n JEOPARDIES] / to put into jeopardy [v JEOPARDIED, JEOPARDYING, JEOPARDIES]
JETTISON	to throw overboard [v -ED, -ING, -S]
JOKING	the act of making a joke [n -S]
JOURNAL	a record of daily events [n -S] / to record in a journal [v JOURNALED or JOURNALLED, JOURNALING or JOURNALLING, JOURNALS]
JOURNALIST	a person engaged in journalism [n -S]
JOVIAL	good-humoured [adj JOVIALLY]
JUDICIOUS	showing judgment [adj JUDICIOUSLY]
JUSTIFY	to vindicate [v JUSTIFIED, JUSTIFYING, JUSTIFIES]
KINGDOM	an area ruled by a king [n -S]
KIOSK	an open booth [n -S]
KNOCK	to strike sharply [v -ED, -ING, -S]
KNOW	to have a true understanding of [v KNEW, KNOWN, KNOWING, KNOWS]
KNOWING	knowledge [n -S] / astute, crafty [adj KNOWINGER, KNOWINGEST, KNOWINGLY]
KNUCKLE	to hit with the joints of the fist [v KNUCKLED, KNUCKLING, KNUCKLES]
LANGUAGE	to express in a body of words serving as communication [v LANGUAGED, LANGUAGING, LANGUAGES]
LAUNCH	to set in motion [v -ED, -ING, -ES]
LAVENDER	a labiate plant with fragrant pale-lilac flowers [n -S] / to perfume with lavender [v -ED, -ING, -S]
LAZIER	LAZY, disinclined toward work or exertion [adj]
LAZINESS	the state of being lazy [n -ES]
LEAVES	LEAVE, to go away from [v]
LEGIBLE	capable of being read [adj LEGIBLY]
LEISURE	free time, also LEASURE [n -S] / to have recreational time [v LEISURED, LEISURING, LEISURES]
LETTING	the act of letting [n -S]
LEVEL	even [adj LEVELLER, LEVELLEST, LEVELLY] / to make even [v LEVELED or LEVELLED, LEVELING or LEVELLING, LEVELS]
LEVELING	LEVEL, to make even [v]
LEVITATE	to rise and float in the air [v LEVITATED, LEVITATING, LEVITATES]
LIBRARY	a room containing books for reading or reference [n LIBRARIES]
LIES	LIE, to make an intentional false statement [v]
LIEUTENANT	an official empowered to act for a higher official [n -S]
LINGUIST	a person skilled in several languages [n -S]
LITIGIOUS	having ready recourse to litigation [adj LITIGIOUSLY]
LIVES	LIVE, to function as a living thing [v]
LLAMA	(Quechua) a South American cud-chewing mammal which belongs to the same family as camels but is smaller and humpless [n -S]
LOATHE	to detest greatly [v LOATHED, LOATHING, LOATHES]
LOGICALLY	LOGICAL, pertaining to logic [adv]
LONELIEST	LONELY, sad from lack of companionship [adj]
LUCKIEST	LUCKY, fortunate [adj]
LULLABY	to lull to sleep with a soothing song [v LULLABIED, LULLABYING, LULLABIES]
LUMINESCENT	showing luminescence [adj]
LUXURY	ease, pleasure and indulgence [n LUXURIES]
MAGICAL	resembling magic [adj MAGICALLY]
MAGICALLY	MAGICAL, resembling magic [adv]
MAGISTRATE	an official entrusted with administration of the laws [n -S]
MAINTENANCE	the act of maintaining [n -S] / to keep in working order [v MAINTENANCED, MAINTENANCING, MAINTENANCES]
MAJESTIC	having majesty, also MAJESTICAL [adj MAJESTICALLY]
MAJORITY	the greater number [n MAJORITIES]
MALT	barley or other grain prepared for brewing or distilling, also MAUT [n -S] / to treat or combine with malt [v -ED, -ING, -S]
MARATHON	a long-distance race [n -S]
MARRIAGE	the legal union of a man and woman [n -S]
MARRIED	one who has entered into marriage [n -S]
MARRIES	MARRY, to enter into marriage [v]
MARRYING	the act of marrying [n -S]
MARVELLED	MARVEL, to be filled with wonder [v]
MASSACRE	to slaughter [v MASSACRED, MASSACRING, MASSACRES]
MATADOR	the bullfighter who kills the bull in a bullfight, also MATADORE [n -S]
MATHEMATICIAN	a specialist or expert in mathematics [n -S]
MEADOW	a tract of grassland [n -S]
MEANWHILE	a period of time while something else is going on [n -S]
MEASURE	to compare with a standard [v MEASURED, MEASURING, MEASURES]
MECHANICS	MECHANIC, a person who works with machines [n]
MEMORANDUM	(Latin) a note to help the memory [n MEMORANDUMS or MEMORANDA]
MERINO	(Spanish) a soft woollen or wool and cotton cloth [n -S]
MERRIEST	MERRY, mirthful, also MERRIE [adj]
MILITARY	relating to armed forces [adj MILITARILY] / armed forces [n MILITARIES]
MINERALS	MINERAL, any of various classes of inorganic substances [n]
MINIATURE	a small or reduced copy, type or breed of anything [n -S] / to miniaturize [v MINIATURED, MINIATURING, MINIATURES]
MINIONS	MINION, a darling, a favourite [n]
MINUTE	to take brief notes [v MINUTED, MINUTING, MINUTES] / very small [adj MINUTER, MINUTEST, MINUTELY]
MISADVENTURE	a misfortune, also MISVENTURE [n -S]
MISCONSTRUE	to construe wrongly, also MISCONSTER [v MISCONSTRUED, MISCONSTRUING, MISCONSTRUES]
MISINTERPRET	to explain wrongly [v -ED, -ING, -S]
MISSIONARY	a person undertaking a mission and esp. a religious mission [n MISSIONARIES]
MOLTEN	made liquid by heat [adj MOLTENLY]
MONOTONY	tedious sameness [n MONOTONIES]
MONTAGE	(French) to combine into a composite picture [v MONTAGED, MONTAGING, MONTAGES]
MOREOVER	in addition [adv]
MOTHERHOOD	the state of being a mother [n -S]
MOULT	to shed feathers or fur, also MOLT [v -ED, -ING, -S]
MOVEMENT	the act of moving [n -S]
MUCUS	the slimy fluid secreted by various membranes in the body, which it moistens and protects [n -ES]
MULTIPLICATION	the act of multiplying [n -S]
MURMUR	to make a subdued muttered sound [v -ED, -ING, -S]
MUSCULAR	pertaining to muscle [adj MUSCULARLY]
MUSICAL	relating to music [adj MUSICALLY] / a show punctuated by songs [n -S]
MUSICIAN	one who performs or composes music [n -S]
MYSTERY	something that cannot be understood or explained [n MYSTERIES]
NAMING	the act of naming [n -S]
NATURE	the qualities of anything which make it what it is [n -S] / to give a particular, or a new, nature to [v NATURED, NATURING, NATURES]
NECESSARILY	NECESSARY, needed [adv]
NEFARIOUS	evil, wicked [adj NEFARIOUSLY]
NEIGHBOURHOOD	a district, locality, esp. with reference to its inhabitants as a community, also NEIGHBORHOOD [n -S]
NOISE	to spread as a rumour or report [v NOISED, NOISING, NOISES]
NOISIEST	NOISY, making loud sounds [adj]
NORMAL	usual [adj NORMALLY] / a normal or usual value [n -S]
NOTICE	to become aware of [v NOTICED, NOTICING, NOTICES]
NOTICEABLE	that can be noticed [adj NOTICEABLY]
NOVEL	new [adj NOVELLY] / a fictional prose narrative [n -S]
NUISANCE	a source of annoyance [n -S]
NUTRIENT	a nourishing substance [n -S]
OBLIGATORY	binding in law or conscience [adj OBLIGATORILY]
OBLIGE	to bind by some favour rendered, also OBLIGATE [v OBLIGED, OBLIGING, OBLIGES]
OBNOXIOUS	unpleasant [adj OBNOXIOUSLY]
OBSESSED	OBSESS, to dominate the thoughts of [v]
OCCASION	to cause [v -ED, -ING, -S]
OCCASIONALLY	OCCASIONAL, of or relating to a particular occasion [adv]
OCCUPATION	an activity in which one engages [n -S]
OFFICIAL	sanctioned by authority [adj OFFICIALLY] / one that holds a position of authority [n -S]
OGRE	a cannibalistic giant [n -S]
OMBUDSMAN	(Swedish) a government official who investigates complaints against government departments [n OMBUDSMEN]
OMINOUS	portending evil [adj OMINOUSLY]
OMIT	to leave out [v OMITTED, OMITTING, OMITS]
ONYX	a form of chalcedony consisting of plane layers of different colours [n -ES]
OPAQUE	impervious to light [adj OPAQUER, OPAQUEST, OPAQUELY] / to make opaque [v OPAQUED, OPAQUING, OPAQUES]
OPERATOR	one who operates [n -S]
OPPRESSION	unjust or cruel exercise of authority or power [n -S]
OPTICIANS	OPTICIAN, one who deals in optical goods [n]
OPULENTLY	OPULENT, wealthy [adv]
ORCHID	any plant or flower of the Orchidaceae, a family of monocotyledons, including many tropical epiphytes [n -S]
ORDINARY	according to the common type [adj ORDINARIER, ORDINARIEST, ORDINARILY] / a rule, an ordinance [n ORDINARIES]
ORIGINAL	relating to the origin [adj ORIGINALLY] / the first form of something [n -S]
ORNAMENTAL	decorative [adj ORNAMENTALLY] / a plant grown for ornament [n -S]
OUTBACK	isolated rural country [n -S]
OUTSIDE	the outer side [n -S]
OVERWHELM	to crush with something strong or heavy [v -ED, -ING, -S]
PAGEANT	an elaborate public spectacle [n -S]
PAINFULLY	PAINFUL, causing pain [adv]
PAINTBRUSH	a brush for applying paint [n -ES]
PALACE	a royal residence [n -S]
PAMPHLET	to circulate a small unbound printed work to [v -ED, -ING, -S]
PARALLEL	of lines etc., extended in the same direction and equidistant in all parts [adj PARALLELLY] / to be extended in the same direction [v PARALLELED or PARALLELLED, PARALLELING or PARALLELLING, PARALLELS]
PARTIAL	not whole [adj PARTIALLY] / as in partial out, to eliminate a factor in statistics [v PARTIALLED, PARTIALLING, PARTIALS]
PASSION	to exhibit strong feeling [v -ED, -ING, -S]
PATCH	to mend or cover a hole [v -ED, -ING, -ES]
PATIENTLY	PATIENT, calm and uncomplaining [adv]
PATTED	PAT, to stroke gently [v]
PATTERN	to copy a design [v -ED, -ING, -S]
PEACEFUL	undisturbed, calm [adj PEACEFULLER, PEACEFULLEST, PEACEFULLY]
PEDESTRIAN	a person going on foot [n -S]
PEDIGREE	a line of ancestors [n -S]
PEOPLE	to stock with inhabitants [v PEOPLED, PEOPLING, PEOPLES]
PERCEPTIBLE	able to be perceived [adj PERCEPTIBLY]
PERCOLATOR	one that percolates [n -S]
PERCUSSION	the act of striking; musical instruments as drums, etc., sounded by being struck [n -S]
PERFORMANCE	the execution of an action [n -S]
PERSIST	to continue resolutely [v -ED, -ING, -S]
PERSONALLY	PERSONAL, related to oneself [adv]
PERSUADING	PERSUADE, to induce by reasoning or entreaty, also PERSWADE [v]
PERSUASIVE	tending to persuade [adj PERSUASIVELY] / that which persuades [n -S]
PERTINENT	belonging or related to the subject or matter in hand [adj PERTINENTLY] / a minor property forming part of a heritable estate [n -S]
PESSIMISTIC	inclined to pessimism, also PESSIMISTICAL [adj PESSIMISTICALLY]
PHANTOM	an immaterial form, a spectre, also PHANTOSME [n -S]
PHOBIA	(Greek) an obsessive or irrational fear, also PHOBISM [n -S]
PHONEYS	PHONEY, to fake, counterfeit [v]
PHOSPHORESCENT	exhibiting phosphorescence [adj]
PHOTOGRAPHING	PHOTOGRAPH, to take a photograph of [v]
PHYSICALLY	PHYSICAL, related to the body [adv]
PHYSICIST	an expert in or student of physics [n -S]
PICTURED	PICTURE, to form a likeness of [v]
PICTURES	PICTURE, to form a likeness of [v]
PIER	a structure extending from land out over water [n -S]
PINCER	one of the two pivoted parts of a grasping tool [n -S] / to grip in pincers [v -ED, -ING, -S]
PINNED	PIN, to fasten with a pin [v]
PITCH	to throw [v PITCHED, (obsolete) YPIGHT, PITCHING, PITCHES]
PITIFUL	arousing pity, also PITEOUS [adj PITIFULLER, PITIFULLEST, PITIFULLY]
PLAIT	to braid [v -ED, -ING, -S]
PLANNER	one who plans [n -S]
PLANNING	the establishment of goals or policies [n -S]
PLEASANT	pleasing [adj PLEASANTER, PLEASANTEST, PLEASANTLY]
PLEASURE	to give enjoyment or satisfaction to [v PLEASURED, PLEASURING, PLEASURES]
PLENTIFUL	abundant [adj PLENTIFULLY]
POETIC	pertaining to poetry [adj POETICALLY]
POISONOUS	having the quality or effect of poison [adj POISONOUSLY]
POLICY	an action or a procedure considered with reference to prudence or expediency, also POLLICIE, POLLICY [n POLICIES]
POLITICIAN	a person experienced in the art or science of government [n -S]
POPCORN	maize or Indian corn, the kernels of which swell up and burst open with a small explosive sound when heated [n -S]
POSSIBLE	that can be done [adj POSSIBLER, POSSIBLEST, POSSIBLY] / something that is possible [n -S]
PRACTICALLY	PRACTICAL, relating to actual practice [adv]
PRAISE	to express admiration or approval of [v PRAISED, PRAISING, PRAISES]
PRANKSTER	one who plays pranks [n -S]
PRECIOUS	valuable [adj PRECIOUSLY] / a sweetheart [n -ES]
PREDICTION	an act of predicting [n -S]
PRESCRIPTION	the act of prescribing [n -S]
PRESTIGE	charm, magic or glamour in the eyes of other people [n -S]
PREVALENCE	the state of being prevalent, also PREVALENCY [n -S]
PRINCIPAL	chief [adj PRINCIPALLY] / the head of a college or university [n -S]
PRINCIPLE	a guiding rule [n -S] / to ground (a person) in the principles or elements of a subject [v PRINCIPLED, PRINCIPLING, PRINCIPLES]
PROBABLY	PROBABLE, likely to occur or prove true [adv]
PROCESSION	to go in procession [v -ED, -ING, -S]
PROCURE	to obtain by effort [v PROCURED, PROCURING, PROCURES]
PROFESSION	a calling [n -S]
PROFESSORS	PROFESSOR, a university or college teacher of the highest grade [n]
PROGNOSIS	a forecasting or forecast, esp. of the course of a disease [n PROGNOSES]
PROJECT	to extend outward [v -ED, -ING, -S]
PROMOTION	the act of promoting [n -S]
PROPERTY	something owned [n PROPERTIES] / to make one's own property, appropriate, take or hold possession of [v PROPERTIED, PROPERTYING, PROPERTIES]
PROPOSITION	to make a proposal to [v -ED, -ING, -S]
PROTEIN	a nitrogenous organic compound, also PROTEID, PROTEIDE [n -S]
PSYCHIATRIST	one who practises psychiatry, also PSYCHIATER [n -S]
PSYCHIC	relating to the psyche, also PSYCHICAL [adj PSYCHICALLY] / one sensitive to extrasensory phenomena [n -S]
PSYCHOLOGY	the science of mind and behavior [n PSYCHOLOGIES]
PUNCTUAL	being on time [adj PUNCTUALLY]
PUNNET	a small shallow fruit basket [n -S]
PURSUIT	the act of pursuing, also POURSUIT [n -S]
QUAINT	pleasantly odd, also QUEINT [adj QUAINTER, QUAINTEST, QUAINTLY]
QUALIFIER	one who qualifies [n -S]
QUARREL	to become involved in an unfriendly dispute [v QUARRELED or QUARRELLED, QUARRELING or QUARRELLING, QUARRELS]
QUARRELLED	QUARREL, to become involved in an unfriendly dispute [v]
QUARTER	to divide into four parts [v -ED, -ING, -S]
QUEEN	a female monarch [n -S] / to make a queen of [v -ED, -ING, -S]
QUESTION	to ask [v -ED, -ING, -S]
QUESTIONNAIRE	a set of questions for obtaining statistically useful or personal information from individuals [n -S]
QUICHE	(French) a flan of plain pastry filled with a cooked egg mixture [n -S]
QUIESCENT	resting, dormant [adj QUIESCENTLY]
QUOTE	to repeat the words of, also COATE [v QUOTED, QUOTING, QUOTES]
RACIAL	pertaining to an ethnic group [adj RACIALLY]
RADIAL	having rays or spokes diverging from the centre [adj RADIALLY] / a radial artery [n -S]
RANCID	rank in taste or smell [adj RANCIDER, RANCIDEST, RANCIDLY]
RAZOR	to shave with a sharp instrument [v -ED, -ING, -S]
READY	prepared [adj READIER, READIEST, READILY] / to make ready [v READIED, READYING, READIES]
REALISTIC	resembling reality, lifelike [adj REALISTICALLY]
REASON	to deduct inferences from premises [v -ED, -ING, -S]
REASSURE	to assure again [v REASSURED, REASSURING, REASSURES]
REBELLED	REBEL, to oppose authority [v]
REBELLING	REBEL, to oppose authority [v]
RECEDE	to move back [v RECEDED, RECEDING, RECEDES]
RECEIVING	the act of receiving [n -S]
RECITE	to say from memory [v RECITED, RECITING, RECITES]
RECOGNISABLE	that can be recognised, also RECOGNIZABLE [adj RECOGNISABLY]
RECRUITMENT	the act of recruiting [n -S]
REDEMPTION	the act of redeeming [n -S]
REFLECTED	REFLECT, to be mirrored [v]
REFLECTIONS	REFLECTION, an image given back by a reflecting surface [n]
REFLECTOR	something or someone that reflects [n -S]
REGIONAL	relating to a region, also REGIONARY [adj REGIONALLY] / something that serves as a region [n -S]
REIN	to restrain [v -ED, -ING, -S]
RELATION	an association between people or things [n -S]
RELEVANT	pertaining to the matter at hand [adj RELEVANTLY]
RELIED	RELY, to depend on confidently [v]
RELIES	RELY, to depend on confidently [v]
RELUCTANT	unwilling [adj RELUCTANTLY]
RELYING	RELY, to depend on confidently [v]
REMARKABLE	worthy of note [adj REMARKABLY] / something worthy of remark [n -S]
REMEMBER	to bring to mind again [v -ED, -ING, -S]
REMINISCENT	of the character of or relating to reminiscence [adj REMINISCENTLY] / something that serves to recall [n -S]
REPLACEABLE	that can be replaced [adj]
REQUIRE	to have need of [v REQUIRED, REQUIRING, REQUIRES]
REQUIRING	the act of requiring [n -S]
RESIDUAL	remaining, also RESIDUOUS [adj RESIDUALLY] / that which remains as a residue [n -S]
RESPECTABLE	worthy of respect [adj RESPECTABLY] / one who is respectable [n -S]
RESPECTFUL	marked by or showing respect [adj RESPECTFULLY]
RESPLENDENT	shining brilliantly [adj RESPLENDENTLY]
RESPONSIBILITY	moral, legal, or mental accountability [n]
RESPONSIBLE	liable to be called to account as being in charge or control; answerable, also SPONSIBLE [adj RESPONSIBLY]
RESTORATION	a bringing back to a former position or condition, also RESTORAL [n -S]
REVISION	a revised version, also REVISAL [n -S]
REVOLUTIONARY	of or like a revolution [adj REVOLUTIONARILY] / one engaged in a revolution [n REVOLUTIONARIES]
RHINOCEROS	a large heavy ungulate mammal of the perissodactyl family Rhinocerotidae, also RHINOCEROT, RHINOCEROTE [n RHINOCEROSES or RHINOCERI or RHINOCEROI]
RHUBARB	any species of the genus Rheum; the leafstalks cooked and used as if fruit [n -S] / to simulate conversation e.g. on stage [v -ED, -ING, -S]
RHYTHM	a pattern of recurrence, also RHYTHMUS [n -S]
RIDICULOUS	arousing or deserving ridicule [adj RIDICULOUSLY]
RODENT	a gnawing mammal [n -S]
RUBBER	to provide with an eraser [v -ED, -ING, -S]
RUBELLA	(Latin) a virus disease, German measles [n -S]
SALARY	to pay periodically for nonmanual labour [v SALARIED, SALARYING, SALARIES]
SALUTATION	an expression of greeting [n -S]
SANCTIMONIOUS	hypocritically pious or devout [adj SANCTIMONIOUSLY]
SAUCE	to serve with a liquid dressing [v SAUCED, SAUCING, SAUCES]
SAUCER	a small shallow dish [n -S]
SAVING	money laid aside for future use [n -S]
SAVIOUR	one who saves, also SAVIOR [n -S]
SCALE	to climb up or over [v SCALED, SCALING, SCALES]
SCARCE	in short supply [adj SCARCER, SCARCEST, SCARCELY]
SCAVENGER	to act as a scavenger, scavenge [v SCAVENGERED, SCAVENGERING, SCAVENGERS]
SCENARIO	(Italian) an outline of a dramatic work [n -S]
SCENE	to set in a place of action [v SCENED, SCENING, SCENES]
SCHEME	to plan or plot [v SCHEMED, SCHEMING, SCHEMES]
SCIMITAR	a curved oriental sword, also CEMITARE, SCIMETAR, SCIMITER, SEMITAR, SEMITAUR, SIMITAR, SYMITAR, SYMITARE [n -S]
SCROUNGE	to gather by foraging [v SCROUNGED, SCROUNGING, SCROUNGES]
SEARCHED	SEARCH, to look carefully for something [v]
SEMBLANCE	an outward appearance [n -S]
SENSATION	consciousness of a physical experience [n -S]
SEPARATE	apart [adj SEPARATELY] / to set or keep apart [v SEPARATED, SEPARATING, SEPARATES]
SEPARATELY	SEPARATE, apart [adv]
SEQUENCE	to arrange in order [v SEQUENCED, SEQUENCING, SEQUENCES]
SERIOUS	thoughtful or subdued in appearance [adj SERIOUSLY]
SHACKLE	to confine with irons around wrists and ankles [v SHACKLED, SHACKLING, SHACKLES]
SHOPPING	the activity of visiting shops [n -S]
SHOULDER	to assume the burden of, also SHOUTHER [v -ED, -ING, -S]
SHREWD	having keen insight [adj SHREWDER, SHREWDEST, SHREWDLY]
SHRIEKED	SHRIEK, to utter a scream, also SCRIKE, SHREEK, SHREIK, SHRIECH, SHRIKE, SHRITCH, SKRIKE [v]
SIGNALLING	the act of signalling [n -S]
SIGNED	SIGN, to write one's name [v]
SIGNIFICANT	having meaning [adj SIGNIFICANTLY] / something having meaning [n -S]
SILHOUETTE	(French) a portrait obtained by tracing the outline of a profile, head, or figure, esp. by means of its shadow [n -S] / to represent or show in silhouette [v SILHOUETTED, SILHOUETTING, SILHOUETTES]
SILLINESS	the state of being silly [n -ES]
SIMPLY	SIMPLE, straightforward, also SEMPLE [adv]
SKETCH	to make a rough, hasty drawing [v -ED, -ING, -ES]
SKILFUL	full of skill, also SKILFULL, SKILLFUL [adj SKILFULLY]
SKILL	the ability to do something well [n -S] / to matter, to signify [v -ED, -ING, -S]
SKIPPED	SKIP, to move with light springing steps [v]
SKULDUGGERY	underhand dealing, trickery, also SCULDUGGERY, SKULLDUGGERY [n SKULDUGGERIES]
SLAPPED	SLAP, to strike with the open hand [v]
SLAUGHTER	the act of killing, also SLAUGHTERY [n -S] / to kill, esp. animals for food [v -ED, -ING, -S]
SLIPPED	SLIP, to slide suddenly and accidentally [v]
SLIPPING	SLIP, to slide suddenly and accidentally [v]
SLUDGE	to cover with a muddy deposit [v SLUDGED, SLUDGING, SLUDGES]
SMILING	wearing a smile [adj SMILINGLY] / the act of smiling [n -S]
SMOKING	to preserve by smoke-drying [n -S]
SOCIAL	related to society [adj SOCIALLY] / a social event [n -S]
SOCIETY	an organized group, a fellowship, also SODALITY [n SOCIETIES]
SOLICITOUS	expressing solicitude [adj SOLICITOUSLY]
SORROWFUL	sad [adj SORROWFULLY]
SPARKLY	sparkling [adj SPARKLIER, SPARKLIEST] / something that sparkles [n SPARKLIES]
SPECIAL	particular [adj SPECIALER, SPECIALEST, SPECIALLY] / to sell at item at a reduced price [v SPECIALLED, SPECIALLING, SPECIALS]
SPECIMEN	a representative of a group or a whole thing [n -S]
SPECTACULAR	of the nature of a spectacle [adj SPECTACULARLY] / something that is spectacular [n -S]
SPIED	SPY, to watch secretly, also SPIE [v]
SPINNING	the act of one who spins [n -S]
SPITEFULLY	SPITEFUL, malicious [adv]
SQUABBLE	to quarrel [v SQUABBLED, SQUABBLING, SQUABBLES]
SQUADRON	to organize in divisions of a regiment [v -ED, -ING, -S]
STATIONARY	fixed in a station, course, or mode [adj STATIONARILY] / something fixed [n STATIONARIES]
STEPPED	STEP, to measure by pacing [v]
STITCH	to sew together [v STITCHED, STITCHING, STITCHES]
STOCK	to keep for future sale or use [v -ED, -ING, -S]
STOMACH	to tolerate [v -ED, -ING, -S]
STORM	to blow violently [v -ED, -ING, -S]
STRATEGY	a plan for obtaining a specific goal [n STRATEGIES]
STRENGTHEN	to make stronger [v -ED, -ING, -S]
STRETCH	to draw out or open to full length [v -ED, -ING, -ES]
STROKING	the act of stroking [n -S]
SUBSIDED	SUBSIDE, to sink to a lower or normal level [v]
SUBSIDIARY	subordinate [adj SUBSIDIARILY] / one that is subsidiary [n SUBSIDIARIES]
SUCCESSFUL	resulting or terminating in success [adj SUCCESSFULLY]
SUCCESSION	a coming after or following [n -S]
SUCROSE	a white crystalline disaccharide composed of a glucose and a fructose unit [n -S]
SUCTION	to remove by sucking [v -ED, -ING, -S]
SUFFICIENT	adequate [adj SUFFICIENTLY] / something sufficient [n -S]
SUITABLY	SUITABLE, appropriate [adv]
SUPPLIED	SUPPLY, to provide with service or goods [v]
SUPPRESSION	an act or instance of suppressing [n -S]
SURFACE	to apply an outer layer to [v SURFACED, SURFACING, SURFACES]
SURPRISE	to come upon unexpectedly, also SURPRIZE [v SURPRISED, SURPRISING, SURPRISES]
SURPRISING	causing surprise [adj SURPRISINGLY] / the act of causing surprise [n -S]
SURREAL	of or relating to surrealism; dreamlike, bizarre [adj SURREALLY] / the atmosphere or qualities associated with surrealism [n -S]
SURRENDER	to yield, give up [v -ED, -ING, -S]
SURROUNDED	SURROUND, to encompass [v]
SURVIVE	to remain in existence [v SURVIVED, SURVIVING, SURVIVES]
SWARM	to move in a large group [v -ED, -ING, -S]
SWIMMING	smooth [adj SWIMMINGLY] / the act of swimming [n -S]
TABLECLOTH	a covering spread over a dining table before the tableware is set [n -S]
TACTILE	pertaining to the sense of touch, also TACTUAL [adj TACTILELY]
TAFFETA	a thin glossy silk, also TAFFETAS [n -S]
TANGIBLE	able to be touched [adj TANGIBLY] / something tangible [n -S]
TECHNICALITY	something technical [n TECHNICALITIES]
TECHNIQUE	a skilled procedure or method [n -S]
TELEPHONE	an instrument for reproducing sound at a distance, esp. by means of electricity [n -S] / to contact someone by telephone [v TELEPHONED, TELEPHONING, TELEPHONES]
TELEPHONING	TELEPHONE, to contact someone by telephone [v]
TEMPERAMENTAL	relating to temperament [adj TEMPERAMENTALLY]
TEMPERATURE	the degree of hotness of a body [n -S]
TEMPORARY	not permanent [adj TEMPORARILY] / someone in a position of temporary employment [n TEMPORARIES]
TERRACE	to form into raised banks [v TERRACED, TERRACING, TERRACES]
TERRESTRIAL	living on land [adj TERRESTRIALLY] / a creature living on land [n -S]
TERRIBLE	awful [adj TERRIBLY] / a terrible thing [n -S]
TERRIBLY	TERRIBLE, awful [adv]
TERRITORIAL	relating to territory [adj TERRITORIALLY] / a member of a territorial military unit [n -S]
THANKFULLY	THANKFUL, grateful [adv]
THEORY	a group of propositions used to explain a class of phenomena [n THEORIES]
THERMONUCLEAR	of, relating to, or employing transformations in the nuclei of atoms of low atomic weight (as hydrogen) that require a very high temperature for their inception (as in the hydrogen bomb or in the sun) [adj]
THESIS	a proposition put forward for discussion [n THESES]
THIEF	one that steals [n THIEVES]
THINNER	a preparation used to thin e.g. paint [n -S]
THOUGHTFULLY	THOUGHTFUL, absorbed in thought [adv]
THOUGHTLESS	insufficiently alert [adj THOUGHTLESSLY]
THWART	cross-grained [adj THWARTLY] / to cross the path of, obstruct [v -ED, -ING, -S]
TIDE	to flow like the rise and fall of the ocean's waters [v TIDED, TIDING, TIDES]
TIDINESS	the state of being tidy [n -ES]
TOMORROW	the day following today [n -S]
TORTOISE	any reptile having the body enclosed in a bony shell [n -S]
TOUCAN	(Tupi) a tropical bird with a large bill [n -S]
TRACE	to follow the course of [v TRACED, TRACING, TRACES]
TRANSPLANT	to lift and reset (a plant) in another soil or situation [v -ED, -ING, -S]
TRAPEZE	to perform on a gymnastic apparatus [v TRAPEZED, TRAPEZING, TRAPEZES]
TREASURE	to value highly [v TREASURED, TREASURING, TREASURES]
TROTTING	the sport of racing for trotting horses pulling a two-wheeled vehicle and driver [n -S]
TRYING	demanding, annoying [adj TRYINGLY] / the act of trying [n -S]
TSUNAMI	(Japanese) a great sea wave produced by submarine earth movement or volcanic eruption [n -S]
TUNNELLING	the act of tunnelling [n -S]
TURNIP	to plant with an edible plant root [v -ED, -ING, -S]
UBIQUITOUS	being everywhere at once, also UBIQUITARY [adj UBIQUITOUSLY]
ULCER	to affect with a type of lesion, also ULCERATE [v -ED, -ING, -S]
UMBRELLA	to provide with a portable shelter against rain or sun [v -ED, -ING, -S]
UNACHIEVABLE	that cannot be achieved [adj]
UNAPPEALING	not appealing [adj UNAPPEALINGLY]
UNATTAINABLE	not attainable [adj UNATTAINABLY]
UNBELIEVABLE	too improbable for belief [adj UNBELIEVABLY]
UNBREAKABLE	not breakable [adj]
UNCERTAIN	not certain, also INCERTAIN [adj UNCERTAINLY]
UNCOORDINATED	not coordinated [adj]
UNDISTURBED	not disturbed [adj UNDISTURBEDLY]
UNEARTH	to dig up [v -ED, -ING, -S]
UNEARTHING	UNEARTH, to dig up [v]
UNEXPECTEDLY	UNEXPECTED, not expected [adv]
UNGRATEFUL	showing no gratitude, also INGRATEFUL [adj UNGRATEFULLY]
UNHEARD	not heard [adj]
UNSOCIABLE	not sociable [adj UNSOCIABLY]
UNTIMELY	not timely [adj UNTIMELIER, UNTIMELIEST]
USELESS	serving no purpose [adj USELESSLY]
UTTER	complete [adj UTTERER, UTTEREST, UTTERLY] / to give audible expression to [v -ED, -ING, -S]
VAIN	filled with undue admiration for oneself [adj VAINER, VAINEST, VAINLY]
VAPOUR	mist, fume or smoke [n -S] / to turn into vapour, also VAPOR [v -ED, -ING, -S]
VARIED	VARY, to make different [v]
VARIOUS	of diverse kinds [adj VARIOUSLY]
VEGETATION	the total aggregation of plant communities within an area [n -S]
VENGEANCE	revenge [n -S]
VERTEBRATES	VERTEBRATE, a backboned animal, one belonging to the subphylum Vertebrata, including fishes, amphibians, reptiles, birds and mammals [n]
VESSEL	a craft for travelling on water [n -S]
VIBRATION	a vibrating [n -S]
VICTORIOUS	having won a victory [adj VICTORIOUSLY]
VINYL	a type of plastic [n -S]
VIOLENCE	a violent action [n -S]
VISIBILITY	the state of being visible [n VISIBILITIES]
VIVACIOUS	lively [adj VIVACIOUSLY]
VOILA	(French) there it is [interj]
VOLUNTEER	to offer one's services [v -ED, -ING, -S]
VULNERABLE	that can be hurt [adj VULNERABLY]
WAD	to form into a pad [v WADDED, WADDING, WADS]
WAIVE	to refrain from claiming [v WAIVED, WAIVING, WAIVES]
WALLET	a small, flat folding case for the pocket [n -S]
WAND	a slender rod [n -S]
WANDER	to move about with no destination or purpose [v -ED, -ING, -S]
WARFARE	to wage war [v WARFARED, WARFARING, WARFARES]
WARY	cautious [adj WARIER, WARIEST, WARILY]
WAS	BE, to exist [v]
WASP	a stinging insect [n -S]
WASTAGE	something that is wasted [n -S]
WEALTH	valuable possessions [n -S]
WEAPON	to supply with an instrument of offence or defence [v -ED, -ING, -S]
WEARISOME	tiresome, also WEARIFUL [adj]
WHEN	the time at which something happened [n -S]
WHILST	as long as [conj]
WHINE	to utter a plaintive, high-pitched sound [v WHINED, WHINING, WHINES]
WHISKER	coarse hair on the face [n -S]
WHISPER	to speak softly [v -ED, -ING, -S]
WHOLE	entire [adj WHOLLY] / all the parts or elements entering into and making up a thing [n -S]
WHOLEHEARTED	completely and sincerely devoted, determined, or enthusiastic [adj WHOLEHEARTEDLY]
WILFUL	bent on having one's own way, also WILLFUL, WILLYARD, WILLYART [adj]
WINNING	captivating, charming [adj WINNINGEST, WINNINGLY] / something won [n -S]
WITCH	to bewitch [v -ED, -ING, -ES]
WITCHERY	enchantment; witchcraft [n WITCHERIES]
WOEFUL	full of woe, also WAEFUL, WAESOME, WOESOME, WOFUL [adj WOEFULLER, WOEFULLEST, WOEFULLY]
WONDERFUL	causing wonder; strange, extraordinary [adj WONDERFULLY]
WORDS	WORD, to express in speech sounds [v]
WRAITH	a visible disembodied spirit [n -S]
WRAP	to enclose [v WRAPT or WRAPPED, WRAPPING, WRAPS]
WREATH	a garland of flowers [n -S]
WRESTLE	to engage in a type of hand-to-hand contest, also RASSLE, WARSLE, WARSTLE, WRASSLE, WRASTLE, WRAXLE [v WRESTLED, WRESTLING, WRESTLES]
WRIGGLED	WRIGGLE, to twist and turn [v]
WROUGHT	WORK, to toil in mind or body [v]
YEARN	to long for [v -ED, -ING, -S]
YIELDING	giving way, compliant [adj YIELDINGLY] / a giving way [n -S]
ZANY	comical, clownish [adj ZANIER, ZANIEST, ZANILY] / (obsolete) to play the zany to [v ZANIED, ZANYING, ZANIES]
ZENITH	the highest point [n -S]
ZINC	to coat with a metallic element [v ZINCKED or ZINCED or ZINKED, ZINCKING or ZINCING or ZINKING, ZINCS]
ZODIAC	an imaginary belt in the heavens [n -S]
